Antediluvian Sloppy Spectacle - Essence
Absence of Light - Animators
Absolute Inebriation - Virtual Dreams,Fairlight
Absolute Swedish 1 - Phew! Productions
Acid In The House - Northstar,The Silents
Acme Slideshow 1991 (Reflection of Perfection) - Acme (Amiga)
A Few Tunes by Dr. Awesome and Fleshbrain - The Crusaders
Alchemy - Rage
Alfred The Music Disk - Relay
Aloha - Rebels
Alpha & Omega - Pure Metal Coders
Alternative Reality - Suspect
Amazing Tunes - Share And Enjoy,Megaforce
Amazing Tunes II - Share And Enjoy
Amplifier 1 - Dimension 4
Analogia - Analog
Anarchy (announcetro/Silents fr last demo) - The Silents,Anarchy
Anarchy party slide - Razor 1911 AnarchyPartySlide
Animotion - Phenomena
Announce - Lemon.
Apocalypse - Gods
Aquarium - Carillon & Cyberiad
Art & Go! - Impulse (.hu)
ARTE - Sanity
Artificial Paradise - New Generation Crew AGA
Art of Noise 3 - Northtech
Art of Noise 4 - Northtech
Assemblo - World Industries
Assembly 1992 Slideshow - World Industries
Astrogate - Byterapers
Atmospherical Melodies - Carnage
Atome - Skarla AGA
Audio Dreams - Chaos
AudiOmega - Rebels
Audio Rhythm 2 - Tronix
Audio Violation - DEFEKT
Audio-X - The Crusaders
Authentik - Skarla AGA
Autumn nights - Palace
Ankara Section Contact Intro - Bronx Intro
Adam McCrory Music Disk 1 - Adam McCrory
A-Sensation - Ramses AGA