Official Commodore France A1200 demo - Digital AGA Demo	O/Official Commodore France	A-Demos:A/A1200DemoAGA/A1200DemoAGA.slave
Oasis - Stellar AGA	O/Oasis - Stellar AGA	A-Demos:O/OasisAGA/OasisAGA.Slave
Oblique Infinity - Goldfire	O/Oblique Infinity - Goldfir	A-Demos:O/ObliqueInfinity/ObliqueInfinity.Slave
Obvious Disaster - Phenomena	O/Obvious Disaster - Phenome	A-Demos:O/ObviousDisaster/ObviousDisaster.Slave
Odeon - Solution	O/Odeon - Solution	A-Demos:O/Odeon/Odeon.Slave
Ode To Ramon - Digital Force	O/Ode To Ramon - Digital For	A-Demos:O/OdeToRamon/OdeToRamon.Slave
Ode to Ramon 2 - The Digital Force	O/Ode to Ramon 2 - The Digit	A-Demos:O/OdeToRamon2/OdeToRamon2.Slave
Odysounds 2 - Odyssey	O/Odysounds 2 - Odyssey	A-Demos:O/OdySounds2/OdySounds2.Slave
Odyssey - Alcatraz	O/Odyssey - Alcatraz	A-Demos:O/Odyssey/Odyssey.Slave
Old Tunes - Chrome	O/Old Tunes - Chrome	A-Demos:O/OldTunes/OldTunes.Slave
One Day On Mars - Exile	O/One Day On Mars - Exile	A-Demos:O/OneDayOnMars/OneDayOnMars.Slave
One Stone -Sport Aid- - Quest	O/One Stone -Sport Aid- - Qu	A-Demos:O/OneStone/OneStone.slave
Optical Dreams - Addict	O/Optical Dreams - Addict	A-Demos:O/OpticalDreams/OpticalDreams.Slave
Orgasm - Old Bulls	O/Orgasm - Old Bulls	A-Demos:O/Orgasm/Orgasm.Slave
Origin - Complex AGA	O/Origin - Complex AGA	A-Demos:O/OriginAGA/OriginAGA.slave
Ottifanten - Thrust	O/Ottifanten - Thrust	A-Demos:O/Ottifanten/Ottifanten.Slave
Ottifanten 2 - Thrust	O/Ottifanten 2 - Thrust	A-Demos:O/Ottifanten2/Ottifanten2.Slave
Our definition of a boombastic demo style - Rebels	O/Our definition of a boomba	A-Demos:O/OurDefOfBoombastic/OurDefOfBoombastic.slave
Overdose - Delight	O/Overdose - Delight	A-Demos:O/Overdose/Overdose.Slave
Overload - Jetset	O/Overload - Jetset	A-Demos:O/Overload/Overload.Slave
Overload 2 - Skid Row,Jetset	O/Overload 2 - Skid Row.Jets	A-Demos:O/Overload2/Overload2.Slave