Dance Diverse Vol 1 - Majic 12	D/Dance Diverse Vol 1 - Maji	A-Demos:D/DanceDiverseVol1/DanceDiverseVol1.Slave
Dance Trance I - Interactive	D/Dance Trance I - Interacti	A-Demos:D/DanceTrance/DanceTrance.Slave
Dance Trance II - Interactive	D/Dance Trance II - Interact	A-Demos:D/DanceTrance2/DanceTrance2.Slave
D.A.N.E - Kefrens	D/D.A.N.E - Kefrens	A-Demos:D/DANE/DANE.slave
Danish Know How - Flash Production	D/Danish Know How - Flash Pr	A-Demos:D/DanishKnowHow/DanishKnowHow.Slave
Darkroom - Stellar	D/Darkroom - Stellar	A-Demos:D/Darkroom/Darkroom.Slave
Darkside - The Black Lotus AGA	D/Darkside - The Black Lotus	A-Demos:D/DarksideAGA/DarksideAGA.Slave
Darktro - Darkness	D/Darktro - Darkness	A-Demos:D/Darktro/Darktro.Slave
Day of Reckoning - Digital	D/Day of Reckoning - Digital	A-Demos:D/DayOfReckoning/DayOfReckoning.Slave
Deadly Jammin 2 - Deathstar	D/Deadly Jammin 2 - Deathsta	A-Demos:D/DeadlyJammin2/DeadlyJammin2.Slave
Decaying paradise - Andromeda	D/Decaying paradise - Androm	A-Demos:D/DecayingParadise/DecayingParadise.Slave
Decibel overload - Cue-X Developments	D/Decibel overload - Cue-X D	A-Demos:D/DecibelOverload/DecibelOverload.Slave
Deep Core - Balance	D/Deep Core - Balance	A-Demos:D/Deepcore/Deepcore.Slave
Deformations - Deform	D/Deformations - Deform	A-Demos:D/Deformations/Deformations.slave
Deja Vu - Anarchy	D/Deja Vu - Anarchy	A-Demos:D/DejaVu/DejaVu.slave
Delicate sounds - Razor 1911	D/Delicate sounds - Razor 19	A-Demos:D/DelicateSounds/DelicateSounds.Slave
Delirium - Deform	D/Delirium - Deform	A-Demos:D/DeliriumDeform/DeliriumDeform.Slave
Delirium - Fraxion	D/Delirium - Fraxion	A-Demos:D/DeliriumFraxion/DeliriumFraxion.Slave
Delirium - Kronical	D/Delirium - Kronical	A-Demos:D/DeliriumKronical/DeliriumKronical.Slave
Demo Disk 1 - Apology	D/Demo Disk 1 - Apology	A-Demos:D/DemoDiskOne/DemodiskOne.Slave
Demo-Disk - Quest	D/Demo-Disk - Quest	A-Demos:D/DemoDiskQuest/DemoDiskQuest.Slave
Demo Disk - Subway	D/Demo Disk - Subway	A-Demos:D/DemoDiskSubway/DemoDiskSubway.Slave
Demon download - The Silents	D/Demon download - The Silen	A-Demos:D/DemonDownload/DemonDownload.Slave
Demons are forever - Doctor Mabuse Orgasm Crackings	D/Demons are forever - Docto	A-Demos:D/DemonsAreForever/DemonsAreForever.Slave
Demon's Rage - Nerve Axis	D/Demons Rage - Nerve Axis	A-Demos:D/DemonsRage/DemonsRage.slave
Desert Dream - Kefrens	D/Desert Dream - Kefrens	A-Demos:D/DesertDream/DesertDream.Slave
Despair - LSD	D/Despair - LSD	A-Demos:D/Despair/Despair.Slave
Det kniber - Rebels	D/Det kniber - Rebels	A-Demos:D/DetKniber/DetKniber.slave
Difficult To Cure - Analog (amiga) AGA	D/Difficult To Cure - Analog	A-Demos:D/DifficultToCureAGA/DifficultToCureAGA.Slave
Diggy Piggys - Channel 42,The Silents	D/Diggy Piggys - Channel 42.	A-Demos:D/DiggyPiggys/DiggyPiggys.Slave
Digital Complexity - Crass	D/Digital Complexity - Crass	A-Demos:D/DigitalComplexityCrass/DigitalComplexityCrass.Slave
Digital concert 1 - Flash Production	D/Digital concert 1 - Flash	A-Demos:D/DigitalConcert/DigitalConcert.Slave
Digital concert 2 - Flash Production	D/Digital concert 2 - Flash	A-Demos:D/DigitalConcert2/DigitalConcert2.Slave
Digital concert 3 - Flash Production	D/Digital concert 3 - Flash	A-Demos:D/DigitalConcert3/DigitalConcert3.Slave
Digital concert 4 - Flash Production	D/Digital concert 4 - Flash	A-Demos:D/DigitalConcert4/DigitalConcert4.Slave
Digital Concert 5 - Flash Production	D/Digital Concert 5 - Flash	A-Demos:D/DigitalConcert5/DigitalConcert5.Slave
Digital concert 6 - Flash Production	D/Digital concert 6 - Flash	A-Demos:D/DigitalConcert6/DigitalConcert6.Slave
Digital innovation - Anarchy	D/Digital innovation - Anarc	A-Demos:D/DigitalInnovation/DigitalInnovation.slave
Digital Music Art - Wildfire	D/Digital Music Art - Wildfi	A-Demos:D/DigitalMusicArt/DigitalMusicArt.Slave
Digital Noises - Ram Jam	D/Digital Noises - Ram Jam	A-Demos:D/DigitalNoises/DigitalNoises.Slave
Digital sounds vol 1 - The Warfalcons	D/Digital sounds vol 1 - The	A-Demos:D/DigitalSounds1/DigitalSounds1.Slave
Dirt - Mystic AGA	D/Dirt - Mystic AGA	A-Demos:D/DirtAGA/DirtAGA.Slave
Disco Fever - Ipec Elite	D/Disco Fever - Ipec Elite	A-Demos:D/DiscoFever/DiscoFever.Slave
Divine Inspiration - Goldfire	D/Divine Inspiration - Goldf	A-Demos:D/DivineInspiration/DivineInspiration.Slave
Dizzy Tunes 1 - Noiseless,The Silents	D/Dizzy Tunes 1 - Noiseless.	A-Demos:D/DizzyTunes/DizzyTunes.Slave
Dizzy Tunes 2 - Spaceballs,noiseless	D/Dizzy Tunes 2 - Spaceballs	A-Demos:D/DizzyTunes2/DizzyTunes2.Slave
Don Martin - Hypnosis	D/Don Martin - Hypnosis	A-Demos:D/DonMartinMusicDisk/DonMartinMusicDisk.Slave
Don't Panic - LSD	D/Dont Panic - LSD	A-Demos:D/DontPanic/DontPanic.Slave
D.O.S - Andromeda	D/D.O.S - Andromeda	A-Demos:D/DOS/DOS.slave
Do the Bartman - Freehand	D/Do the Bartman - Freehand	A-Demos:D/DoTheBartman/DoTheBartman.Slave
Double Intro Part1 - Vega Intro	D/Double Intro Part1 - Vega	A-Demos:D/DoubleIntro/DoubleIntro.Slave
Dragon Lord - Alfaforce	D/Dragon Lord - Alfaforce	A-Demos:D/DragonLord/DragonLord.Slave
Dream Trippin' - Digital	D/Dream Trippin - Digital	A-Demos:D/DreamTrippin/DreamTrippin.Slave
Drums & Pipes - Surprise!Productions,Tristar & Red Sector Inc.	D/Drums Pipes - SurpriseProd	A-Demos:D/Drums&Pipes/Drums&Pipes.Slave
Drums & Reverbs - Chryseis	D/Drums Reverbs - Chryseis	A-Demos:D/Drums&Reverbs/Drums&Reverbs.Slave
Dynamo - Orion	D/Dynamo - Orion	A-Demos:D/Dynamo/Dynamo.Slave
Dyspepsia - Analogy	D/Dyspepsia - Analogy	A-Demos:D/Dyspepsia/Dyspepsia.Slave