Gate To Hell - Technology	G/Gate To Hell - Technology	A-Demos:G/GateToHell/GateToHell.Slave
Gathering 91 - Byterapers,Scoopex	G/Gathering 91 - Byterapers.	A-Demos:G/Gathering91Slideshow/Gathering91Slideshow.Slave
Gathering 1993 Partyslides - Majic 12	G/Gathering 1993 Partyslides	A-Demos:G/Gathering93Slideshow/Gathering93Slideshow.Slave
Gen4 Demo - Dragons Demo	G/Gen4 Demo - Dragons Demo	A-Demos:G/Gen4Demo/Gen4Demo.Slave
Gevalia - Polka brothers AGA	G/Gevalia - Polka brothers A	A-Demos:G/Gevalia/Gevalia.Slave
Gigademo 3 - Triangle,The Gang Demo3	G/Gigademo 3 - Triangle.The	A-Demos:G/GigaDemo3/GigaDemo3.Slave
Gladiator music - Cryptoburners	G/Gladiator music - Cryptobu	A-Demos:G/GladiatorMusic/GladiatorMusic.Slave
Global Trash - The Silents	G/Global Trash - The Silents	A-Demos:G/GlobalTrash/GlobalTrash.Slave
Gloom Party Invitation - Gloom	G/Gloom Party Invitation - G	A-Demos:G/GloomPartyInvitation/GloomPartyInvitation.slave
Glow - The Black Lotus AGA	G/Glow - The Black Lotus AGA	A-Demos:G/GlowAGA/GlowAGA.slave
Goa - The Black Lotus AGA	G/Goa - The Black Lotus AGA	A-Demos:G/GoaAGA/GoaAGA.Slave
Go For The Record - Quartz	G/Go For The Record - Quartz	A-Demos:G/GoForTheRecord/GoForTheRecord.Slave
Grapevine Megamix - LSD	G/Grapevine Megamix - LSD	A-Demos:G/GrapevineMegamix/GrapevineMegamix.slave
Great Bytes In Fire - Cyberiad	G/Great Bytes In Fire - Cybe	A-Demos:G/GreatBytesInFire/GreatBytesInFire.Slave
Greatest Bits 2 - Pussy	G/Greatest Bits 2 - Pussy	A-Demos:G/GreatestBits2/GreatestBits2.Slave
Greatest Hits - Cult	G/Greatest Hits - Cult	A-Demos:G/GreatestHits/GreatestHits.Slave
Groovy! - Lemon.	G/Groovy - Lemon.	A-Demos:G/Groovy/Groovy.slave
Groovy Jives #3 - Relay	G/Groovy Jives 3 - Relay	A-Demos:G/GroovyJives3/GroovyJives3.slave
Guardian Dragon - Kefrens	G/Guardian Dragon - Kefrens	A-Demos:G/GuardianDragon/GuardianDragon.slave
Guardian Dragon 2 - Kefrens	G/Guardian Dragon 2 - Kefren	A-Demos:G/GuardianDragon2/GuardianDragon2.slave