Plays 2 unlimited - Scoopex
Party demo - Mute 101
Pack van pee #1 - Jetset
Pack van pee #3 - Jetset
Panic - Voices of Energy - Alcatraz
Paralytic noises - Inzzest
Pastel Vanilla - Nova
Peace in the Gulf - Animators
Pee Wee - Complex AGA
Picture Book - Axis AGA
Pixeled Pleasures - Them
Pixel Nation - Defjam
Planet M. - Melon Dezign AGA
Plastic Passion - UPFRONT
Playbyte Commercial - Shining
Point blank - Andromeda
Power and Agony - Trackers
Powertrax - The Light Circle
Prism - Melon Dezign
Project Beat - Crusaders
Project Techno - Quartz
Pro S.I.A.K. - Flying Cows Inc.
Psychedelic - Virtual Dreams,Fairlight AGA
Psychic - Effect
Psygnosis Musical Picture Disc #1 - Psygnosis & S.R.S PsygnosisMusicPictureDis
Psygnosis Musical Picture Disc #1 - Psygnosis & S.R.S PsygnosisMusicPictureDi0
Public Attack - Cult
Puggs in Space - Dionysus
Purple - Warfalcons
P.o.n.d (sploosh 1.5) - Anthrox