1001 Stolen Ideas - Airwalk AGA	0-9/1001 Stolen Ideas - Airwal	A-Demos:0-9/1001StolenIdeas/1001StolenIdeas.Slave
The 100 most remembered c64 game tunes - Sundell & Birk	T/The 100 most remembered c6	A-Demos:0-9/100MostRememberedC64Tunes/100MostRememberedC64Tunes.slave
242 - Fairlight,Virtual Dreams	0-9/242 - Fairlight.Virtual Dr	A-Demos:0-9/242/242.slave
24 Hour E Fix - Quartz Fix	0-9/24 Hour E Fix - Quartz Fix	A-Demos:0-9/24HourEFix/24HourEFix.Slave
2d - Remedy (amiga)	0-9/2d - Remedy amiga	A-Demos:0-9/2D/2D.Slave
Plays 2 unlimited - Scoopex	P/Plays 2 unlimited - Scoope	A-Demos:0-9/2Unlimited/2Unlimited.Slave
2 unlimited No Limit - Project A	0-9/2 unlimited No Limit - Pro	A-Demos:0-9/2UnlimitedNoLimit/2UnlimitedNoLimit.Slave
3D balls - Avenger	0-9/3D balls - Avenger	A-Demos:0-9/3DBalls/3DBalls.Slave
3D DEMO - Anarchy Demo	0-9/3D DEMO - Anarchy Demo	A-Demos:0-9/3DDemo/3DDemo.Slave
3D-DEMO 2 - Anarchy Demo2	0-9/3D-DEMO 2 - Anarchy Demo2	A-Demos:0-9/3DDemo2/3DDemo2.Slave
3D-Net-Analyzer - Doctor Mabuse Orgasm Crackings	0-9/3D-Net-Analyzer - Doctor M	A-Demos:0-9/3DNetAnalyzer/3DNetAnalyzer.Slave
5 Yards - Vision	0-9/5 Yards - Vision	A-Demos:0-9/5Yards/5Yards.Slave
8-Bit Jungle - Unstable Label	0-9/8-Bit Jungle - Unstable La	A-Demos:0-9/8BitJungle/8BitJungle.slave
9 Fingers - Spaceballs	0-9/9 Fingers - Spaceballs	A-Demos:0-9/9Fingers/9Fingers.Slave
Antediluvian Sloppy Spectacle - Essence	A/Antediluvian Sloppy Specta	A-Demos:A/A.S.S/A.S.S.slave
Official Commodore France A1200 demo - Digital AGA Demo	O/Official Commodore France	A-Demos:A/A1200DemoAGA/A1200DemoAGA.slave
Absence of Light - Animators	A/Absence of Light - Animato	A-Demos:A/AbsenceOfLight/AbsenceOfLight.Slave
Absolute Inebriation - Virtual Dreams,Fairlight	A/Absolute Inebriation - Vir	A-Demos:A/AbsoluteInebriation/AbsoluteInebriation.Slave
Absolute Swedish 1 - Phew! Productions	A/Absolute Swedish 1 - Phew	A-Demos:A/AbsoluteSwedish/AbsoluteSwedish.slave
Acid In The House - Northstar,The Silents	A/Acid In The House - Norths	A-Demos:A/AcidInTheHouse/AcidInTheHouse.Slave
Acme Slideshow 1991 (Reflection of Perfection) - Acme (Amiga)	A/Acme Slideshow 1991 Reflec	A-Demos:A/Acme1991Slideshow/Acme1991Slideshow.Slave
A Few Tunes by Dr. Awesome and Fleshbrain - The Crusaders	A/A Few Tunes by Dr. Awesome	A-Demos:A/AFewTunes/AFewTunes.Slave
Alchemy - Rage	A/Alchemy - Rage	A-Demos:A/Alchemy/Alchemy.Slave
Alfred The Music Disk - Relay	A/Alfred The Music Disk - Re	A-Demos:A/AlfredTheMusicDisk/AlfredTheMusicDisk.slave
Algebra - Dragon Stone	A/Algebra - Dragon Stone	A-Demos:A/Algebra/Algebra.Slave
Aloha - Rebels	A/Aloha - Rebels	A-Demos:A/Aloha/Aloha.Slave
Alpha & Omega - Pure Metal Coders	A/Alpha Omega - Pure Metal C	A-Demos:A/Alpha&Omega/Alpha&Omega.Slave
Alternative Reality - Suspect	A/Alternative Reality - Susp	A-Demos:A/AlternativeReality/AlternativeReality.Slave
Amazing Tunes - Share And Enjoy,Megaforce	A/Amazing Tunes - Share And	A-Demos:A/AmazingTunes/AmazingTunes.Slave
Amazing Tunes II - Share And Enjoy	A/Amazing Tunes II - Share A	A-Demos:A/AmazingTunes2/AmazingTunes2.Slave
Amplifier 1 - Dimension 4	A/Amplifier 1 - Dimension 4	A-Demos:A/Amplifier1/Amplifier1.Slave
The Amplifier 2 - Dimension4	T/The Amplifier 2 - Dimensio	A-Demos:A/Amplifier2/Amplifier2.slave
Analogia - Analog	A/Analogia - Analog	A-Demos:A/Analogia/Analogia.Slave
Anarchy (announcetro/Silents fr last demo) - The Silents,Anarchy	A/Anarchy announcetroSilents	A-Demos:A/AnarchyAnnouncetro/AnarchyAnnouncetro.Slave
Anarchy party slide - Razor 1911 AnarchyPartySlide	A/Anarchy party slide - Razo	A-Demos:A/AnarchyParty1991Slideshow/AnarchyPartySlide.Slave
The Animatunes - New Generation Crew AGA	T/The Animatunes - New Gener	A-Demos:A/AnimatunesAGA/AnimatunesAGA.slave
Animotion - Phenomena	A/Animotion - Phenomena	A-Demos:A/Animotion/Animotion.slave
Announce - Lemon.	A/Announce - Lemon.	A-Demos:A/Announce/Announce.Slave
Apocalypse - Gods	A/Apocalypse - Gods	A-Demos:A/Apocalypse/Apocalypse.Slave
Aquarium - Carillon & Cyberiad	A/Aquarium - Carillon Cyberi	A-Demos:A/Aquarium/Aquarium.Slave
Art & Go! - Impulse (.hu)	A/Art Go - Impulse .hu	A-Demos:A/Art&Go/Art&Go.Slave
ARTE - Sanity	A/ARTE - Sanity	A-Demos:A/Arte/Arte.Slave
Artificial Paradise - New Generation Crew AGA	A/Artificial Paradise - New	A-Demos:A/ArtificialParadiseAGA/ArtificialParadiseAGA.slave
Art of Noise 3 - Northtech	A/Art of Noise 3 - Northtech	A-Demos:A/ArtOfNoise3/ArtOfNoise3.Slave
Art of Noise 4 - Northtech	A/Art of Noise 4 - Northtech	A-Demos:A/ArtOfNoise4/ArtOfNoise4.Slave
Assemblo - World Industries	A/Assemblo - World Industrie	A-Demos:A/Assemblo/Assemblo.Slave
Assembly 1992 Slideshow - World Industries	A/Assembly 1992 Slideshow -	A-Demos:A/Assembly92Slideshow/Assembly92Slideshow.Slave
Astrogate - Byterapers	A/Astrogate - Byterapers	A-Demos:A/Astrogate/Astrogate.Slave
Atmospherical Melodies - Carnage	A/Atmospherical Melodies - C	A-Demos:A/AtmosphericalMelodies/AtmosphericalMelodies.Slave
Atome - Skarla AGA	A/Atome - Skarla AGA	A-Demos:A/AtomeAGA/AtomeAGA.Slave
The Audience is Listening - Taipan	T/The Audience is Listening	A-Demos:A/AudienceIsListening/AudienceIsListening.Slave
Audio Dreams - Chaos	A/Audio Dreams - Chaos	A-Demos:A/AudioDreams/AudioDreams.Slave
AudiOmega - Rebels	A/AudiOmega - Rebels	A-Demos:A/AudiOmega/AudiOmega.Slave
Audio Rhythm 2 - Tronix	A/Audio Rhythm 2 - Tronix	A-Demos:A/AudioRhythm2/AudioRhythm2.Slave
Audio Violation - DEFEKT	A/Audio Violation - DEFEKT	A-Demos:A/AudioViolation/AudioViolation.slave
Audio-X - The Crusaders	A/Audio-X - The Crusaders	A-Demos:A/AudioX/AudioX.slave
Authentik - Skarla AGA	A/Authentik - Skarla AGA	A-Demos:A/AuthentikAGA/AuthentikAGA.Slave
Autumn nights - Palace	A/Autumn nights - Palace	A-Demos:A/AutumnNights/AutumnNights.slave
Back 2 Base - Crusaders	B/Back 2 Base - Crusaders	A-Demos:B/Back2Base/Back2Base.Slave
Bacteria - The Crusaders	B/Bacteria - The Crusaders	A-Demos:B/Bacteria/Bacteria.slave
Bandit's Radio - Mad elks	B/Bandits Radio - Mad elks	A-Demos:B/BanditsRadio/BanditsRadio.Slave
Banging Raves - Intuition	B/Banging Raves - Intuition	A-Demos:B/BangingRaves/BangingRaves.Slave
Banging Raves 2 - Intuition	B/Banging Raves 2 - Intuitio	A-Demos:B/BangingRaves2/BangingRaves2.Slave
Bard in a box - Academy	B/Bard in a box - Academy	A-Demos:B/BardInABox/BardInABox.slave
Basso Continuo - Fury	B/Basso Continuo - Fury	A-Demos:B/BassoContinuo/BassoContinuo.Slave
Bass-o-matic - Crusaders	B/Bass-o-matic - Crusaders	A-Demos:B/BassOMatic/BassOMatic.Slave
Batman Vuelve - Batman Group	B/Batman Vuelve - Batman Gro	A-Demos:B/BatmanVuelve/BatmanVuelve.Slave
Baygon - Melon Dezign AGA	B/Baygon - Melon Dezign AGA	A-Demos:B/BaygonAGA/BaygonAGA.Slave
BBS Intro - Taurus Intro	B/BBS Intro - Taurus Intro	A-Demos:B/BBSIntro/BBSIntro.Slave
Beach Volley - Paradox Demo	B/Beach Volley - Paradox Dem	A-Demos:B/BeachVolleyDemo/BeachVolleyDemo.Slave
Beast sonix - Scoopex	B/Beast sonix - Scoopex	A-Demos:B/BeastSonix/BeastSonix.Slave
Beat Box - Warfalcons	B/Beat Box - Warfalcons	A-Demos:B/BeatBox/BeatBox.Slave
Beatvise - Ivory	B/Beatvise - Ivory	A-Demos:B/Beatvise/Beatvise.Slave
The Beginning - Byterapers	T/The Beginning - Byterapers	A-Demos:B/Beginning/Beginning.Slave
Bernard Sumner Music Disk 1 - Relay BernhardSumnerMD1	B/Bernard Sumner Music Disk	A-Demos:B/BernhardSumnerMusicDisk1/BernhardSumnerMD1.Slave
Sounddisk 2 -The Best of Grubi- - Brainstorm	S/Sounddisk 2 -The Best of G	A-Demos:B/BestOfGrubi/BestOfGrubi.Slave
The Best of Pearl - Byte Busters	T/The Best of Pearl - Byte B	A-Demos:B/BestOfPearl/BestOfPearl.Slave
Best of RAF - Katharsis	B/Best of RAF - Katharsis	A-Demos:B/BestOfRAFVol1/BestOfRAFVol1.Slave
Beyond Justice - Dexion	B/Beyond Justice - Dexion	A-Demos:B/BeyondJustice/BeyondJustice.Slave
Beyond the future - Union AGA	B/Beyond the future - Union	A-Demos:B/BeyondTheFutureAGA/BeyondTheFutureAGA.Slave
Big business - Defjam	B/Big business - Defjam	A-Demos:B/BigBusiness/BigBusiness.Slave
The B.I.G. Demo - Mr. Styckx Demo	T/The B.I.G. Demo - Mr. Styc	A-Demos:B/BIGDemo/BIGDemo.Slave
Big time sensuality - Axis AGA	B/Big time sensuality - Axis	A-Demos:B/BigTimeSensualityAGA/BigTimeSensualityAGA.slave
Black Energy - Hardline	B/Black Energy - Hardline	A-Demos:B/BlackEnergy/BlackEnergy.Slave
Black'n White Slide - Drifters,Pentagon (Amiga)	B/Blackn White Slide - Drift	A-Demos:B/BlackNWhite/BlackNWhite.Slave
Blasting - Gate	B/Blasting - Gate	A-Demos:B/Blasting/Blasting.Slave
Blue house 2 - Rebels	B/Blue house 2 - Rebels	A-Demos:B/BlueHouse2/BlueHouse2.slave
Blues House - The Silents	B/Blues House - The Silents	A-Demos:B/BluesHouse/BluesHouse.Slave
Bomb The Bass - Tuneshow 2 - The Top Boys	B/Bomb The Bass - Tuneshow 2	A-Demos:B/BombTheBassTuneshow2/BombTheBassTuneshow2.Slave
Book Of Songs - Complex	B/Book Of Songs - Complex	A-Demos:B/BookOfSongs/BookOfSongs.Slave
Boris Vallejo - Apocalypse Bay	B/Boris Vallejo - Apocalypse	A-Demos:B/BorisVallejoSlide/BorisVallejoSlide.Slave
Boulder Demo - Tristar Demo	B/Boulder Demo - Tristar Dem	A-Demos:B/BoulderDemo/BoulderDemo.Slave
Boundless Void - Nemol	B/Boundless Void - Nemol	A-Demos:B/BoundlessVoid/BoundlessVoid.slave
The Breath Of The Muse - Chryseis,Poseidon AGA	T/The Breath Of The Muse - C	A-Demos:B/BreathOfTheMuseAGA/BreathOfTheMuseAGA.Slave
Breathtaker - Virtual Dreams,Fairlight AGA	B/Breathtaker - Virtual Drea	A-Demos:B/BreathtakerAGA/BreathtakerAGA.Slave
Breed CD1 - Nightbreed	B/Breed CD1 - Nightbreed	A-Demos:B/BreedCD1/BreedCD1.Slave
Bruno's Musicbox II - Gate	B/Brunos Musicbox II - Gate	A-Demos:B/BrunosMusicBox2/BrunosMusicBox2.Slave
Brunos box 3 - Anarchy	B/Brunos box 3 - Anarchy	A-Demos:B/BrunosMusicBox3/BrunosMusicBox3.Slave
Bubonic Plague - Bloodsuckers	B/Bubonic Plague - Bloodsuck	A-Demos:B/BubonicPlague/BubonicPlague.Slave
Burning Spear - The Dark Demon	B/Burning Spear - The Dark D	A-Demos:B/BurningSpear/BurningSpear.Slave
C-64 - Quadlite Demos	C/C-64 - Quadlite Demos	A-Demos:C/C64Demos/C64Demos.Slave
Can I Play With Madness ? - Defcon One	C/Can I Play With Madness -	A-Demos:C/CanIPlayWithMadness/CanIPlayWithMadness.Slave
Capricorn One - Cydonia	C/Capricorn One - Cydonia	A-Demos:C/CapricornOne/CapricornOne.Slave
Captured Dreams - The Black Lotus AGA	C/Captured Dreams - The Blac	A-Demos:C/CapturedDreamsAGA/CapturedDreamsAGA.Slave
Cebit'89 - Exact	C/Cebit89 - Exact	A-Demos:C/Cebit89/Cebit89.Slave
Cebit demo 90 - Revenge of babbnaasen - Red Sector Inc.	C/Cebit demo 90 - Revenge of	A-Demos:C/Cebit90/Cebit90.Slave
Celebration - IT	C/Celebration - IT	A-Demos:C/Celebration/Celebration.Slave
Cerebral Delights - Goldfire	C/Cerebral Delights - Goldfi	A-Demos:C/CerebralDelights/CerebralDelights.Slave
Checked implosion - Intryx	C/Checked implosion - Intryx	A-Demos:C/CheckedImplosion/CheckedImplosion.Slave
Cherokee - Manitou	C/Cherokee - Manitou	A-Demos:C/Cherokee/Cherokee.Slave
Chip Attack - Anathema	C/Chip Attack - Anathema	A-Demos:C/ChipAttack/ChipAttack.Slave
Chip Music Festival - Magnetic Fields	C/Chip Music Festival - Magn	A-Demos:C/ChipMusic/ChipMusic.Slave
Chip Music Festival - Magnetic Fields	C/Chip Music Festival - M V2	A-Demos:C/ChipMusicFestival/ChipMusicFestival.Slave
Chords - Foundation	C/Chords - Foundation	A-Demos:C/Chords/Chords.Slave
Chromagic - Dual Crew & Shining	C/Chromagic - Dual Crew Shin	A-Demos:C/Chromagic/Chromagic.Slave
Circle Scroller - United Forces	C/Circle Scroller - United F	A-Demos:C/CircleScroller/CircleScroller.Slave
Clapping World - Subway	C/Clapping World - Subway	A-Demos:C/ClappingWorld/ClappingWorld.Slave
Coca Cola - Fraxion Demo	C/Coca Cola - Fraxion Demo	A-Demos:C/CocaColaDemo/CocaColaDemo.Slave
Coder Trash - Mexx	C/Coder Trash - Mexx	A-Demos:C/Codertrash/Codertrash.Slave
Color Crime - X-Trade	C/Color Crime - X-Trade	A-Demos:C/ColorCrime/ColorCrime.Slave
Colors - Devils	C/Colors - Devils	A-Demos:C/Colors/Colors.Slave
Coma - Rebels	C/Coma - Rebels	A-Demos:C/Coma/Coma.Slave
Compact Music Disk 1 - Semtex	C/Compact Music Disk 1 - Sem	A-Demos:C/CompactMusicDisk1/CompactMusicDisk1.Slave
Compilation Disk - PowerLords	C/Compilation Disk - PowerLo	A-Demos:C/CompilationDisk/CompilationDisk.Slave
The Complete - Talent	T/The Complete - Talent	A-Demos:C/Complete/Complete.Slave
Concept Criminosical - Ruthless	C/Concept Criminosical - Rut	A-Demos:C/ConceptCriminosical/ConceptCriminosical.Slave
Ankara Section Contact Intro - Bronx Intro	A/Ankara Section Contact Int	A-Demos:C/ContactIntro/ContactIntro.Slave
Contravention - Reality	C/Contravention - Reality	A-Demos:C/Contravention/Contravention.Slave
Control - Oxygene AGA	C/Control - Oxygene AGA	A-Demos:C/ControlAGA/ControlAGA.slave
Copper cabana - Quadlite	C/Copper cabana - Quadlite	A-Demos:C/CopperCabana/CopperCabana.Slave
Copper master - Angels	C/Copper master - Angels	A-Demos:C/CopperMaster/CopperMaster.slave
Copper slave - Ram Jam	C/Copper slave - Ram Jam	A-Demos:C/CopperSlave/CopperSlave.Slave
Crayon Shinchan - Melon Dezign	C/Crayon Shinchan - Melon De	A-Demos:C/CrayonShinchan/CrayonShinchan.Slave
Crazy Sexy Cool - Essence AGA	C/Crazy Sexy Cool - Essence	A-Demos:C/CrazySexyCoolAGA/CrazySexyCoolAGA.Slave
Crazy Sounds II - Team-X	C/Crazy Sounds II - Team-X	A-Demos:C/CrazySounds2/CrazySounds2.Slave
Creamy Cranium 1 - Strangers	C/Creamy Cranium 1 - Strange	A-Demos:C/CreamyCranium1/CreamyCranium1.Slave
Crystal Symphonies - Phenomena	C/Crystal Symphonies - Pheno	A-Demos:C/CrystalSymphonies/CrystalSymphonies.slave
Crystal Symphonies 2 - Phenomena	C/Crystal Symphonies 2 - Phe	A-Demos:C/CrystalSymphonies2/CrystalSymphonies2.slave
Curiosity - Pseudodos	C/Curiosity - Pseudodos	A-Demos:C/Curiosity/Curiosity.Slave
Cutcreations - Static bytes	C/Cutcreations - Static byte	A-Demos:C/Cutcreations/Cutcreations.Slave
Cyber Sounds - Bastards	C/Cyber Sounds - Bastards	A-Demos:C/CyberSounds/CyberSounds.Slave
Dance Diverse Vol 1 - Majic 12	D/Dance Diverse Vol 1 - Maji	A-Demos:D/DanceDiverseVol1/DanceDiverseVol1.Slave
Dance Trance I - Interactive	D/Dance Trance I - Interacti	A-Demos:D/DanceTrance/DanceTrance.Slave
Dance Trance II - Interactive	D/Dance Trance II - Interact	A-Demos:D/DanceTrance2/DanceTrance2.Slave
D.A.N.E - Kefrens	D/D.A.N.E - Kefrens	A-Demos:D/DANE/DANE.slave
Danish Know How - Flash Production	D/Danish Know How - Flash Pr	A-Demos:D/DanishKnowHow/DanishKnowHow.Slave
Darkroom - Stellar	D/Darkroom - Stellar	A-Demos:D/Darkroom/Darkroom.Slave
Darkside - The Black Lotus AGA	D/Darkside - The Black Lotus	A-Demos:D/DarksideAGA/DarksideAGA.Slave
Darktro - Darkness	D/Darktro - Darkness	A-Demos:D/Darktro/Darktro.Slave
Day of Reckoning - Digital	D/Day of Reckoning - Digital	A-Demos:D/DayOfReckoning/DayOfReckoning.Slave
Deadly Jammin 2 - Deathstar	D/Deadly Jammin 2 - Deathsta	A-Demos:D/DeadlyJammin2/DeadlyJammin2.Slave
Decaying paradise - Andromeda	D/Decaying paradise - Androm	A-Demos:D/DecayingParadise/DecayingParadise.Slave
Decibel overload - Cue-X Developments	D/Decibel overload - Cue-X D	A-Demos:D/DecibelOverload/DecibelOverload.Slave
Deep Core - Balance	D/Deep Core - Balance	A-Demos:D/Deepcore/Deepcore.Slave
Deformations - Deform	D/Deformations - Deform	A-Demos:D/Deformations/Deformations.slave
Deja Vu - Anarchy	D/Deja Vu - Anarchy	A-Demos:D/DejaVu/DejaVu.slave
Delicate sounds - Razor 1911	D/Delicate sounds - Razor 19	A-Demos:D/DelicateSounds/DelicateSounds.Slave
Delirium - Deform	D/Delirium - Deform	A-Demos:D/DeliriumDeform/DeliriumDeform.Slave
Delirium - Fraxion	D/Delirium - Fraxion	A-Demos:D/DeliriumFraxion/DeliriumFraxion.Slave
Delirium - Kronical	D/Delirium - Kronical	A-Demos:D/DeliriumKronical/DeliriumKronical.Slave
Demo Disk 1 - Apology	D/Demo Disk 1 - Apology	A-Demos:D/DemoDiskOne/DemodiskOne.Slave
Demo-Disk - Quest	D/Demo-Disk - Quest	A-Demos:D/DemoDiskQuest/DemoDiskQuest.Slave
Demo Disk - Subway	D/Demo Disk - Subway	A-Demos:D/DemoDiskSubway/DemoDiskSubway.Slave
Party demo - Mute 101	P/Party demo - Mute 101	A-Demos:D/DemoMute101/DemoMute101.Slave
Demon download - The Silents	D/Demon download - The Silen	A-Demos:D/DemonDownload/DemonDownload.Slave
Demons are forever - Doctor Mabuse Orgasm Crackings	D/Demons are forever - Docto	A-Demos:D/DemonsAreForever/DemonsAreForever.Slave
Demon's Rage - Nerve Axis	D/Demons Rage - Nerve Axis	A-Demos:D/DemonsRage/DemonsRage.slave
Hinch Demo - Decay Demo	H/Hinch Demo - Decay Demo	A-Demos:D/DerrynHinchDemo/DerrynHinchDemo.Slave
Desert Dream - Kefrens	D/Desert Dream - Kefrens	A-Demos:D/DesertDream/DesertDream.Slave
Despair - LSD	D/Despair - LSD	A-Demos:D/Despair/Despair.Slave
Det kniber - Rebels	D/Det kniber - Rebels	A-Demos:D/DetKniber/DetKniber.slave
Megademo 4 - Devil's Key - Alcatraz	M/Megademo 4 - Devils Key -	A-Demos:D/DevilsKey/DevilsKey.slave
Difficult To Cure - Analog (amiga) AGA	D/Difficult To Cure - Analog	A-Demos:D/DifficultToCureAGA/DifficultToCureAGA.Slave
Diggy Piggys - Channel 42,The Silents	D/Diggy Piggys - Channel 42.	A-Demos:D/DiggyPiggys/DiggyPiggys.Slave
Digital Complexity - Crass	D/Digital Complexity - Crass	A-Demos:D/DigitalComplexityCrass/DigitalComplexityCrass.Slave
Digital concert 1 - Flash Production	D/Digital concert 1 - Flash	A-Demos:D/DigitalConcert/DigitalConcert.Slave
Digital concert 2 - Flash Production	D/Digital concert 2 - Flash	A-Demos:D/DigitalConcert2/DigitalConcert2.Slave
Digital concert 3 - Flash Production	D/Digital concert 3 - Flash	A-Demos:D/DigitalConcert3/DigitalConcert3.Slave
Digital concert 4 - Flash Production	D/Digital concert 4 - Flash	A-Demos:D/DigitalConcert4/DigitalConcert4.Slave
Digital Concert 5 - Flash Production	D/Digital Concert 5 - Flash	A-Demos:D/DigitalConcert5/DigitalConcert5.Slave
Digital concert 6 - Flash Production	D/Digital concert 6 - Flash	A-Demos:D/DigitalConcert6/DigitalConcert6.Slave
Digital innovation - Anarchy	D/Digital innovation - Anarc	A-Demos:D/DigitalInnovation/DigitalInnovation.slave
Digital Music Art - Wildfire	D/Digital Music Art - Wildfi	A-Demos:D/DigitalMusicArt/DigitalMusicArt.Slave
Digital Noises - Ram Jam	D/Digital Noises - Ram Jam	A-Demos:D/DigitalNoises/DigitalNoises.Slave
Digital sounds vol 1 - The Warfalcons	D/Digital sounds vol 1 - The	A-Demos:D/DigitalSounds1/DigitalSounds1.Slave
Dirt - Mystic AGA	D/Dirt - Mystic AGA	A-Demos:D/DirtAGA/DirtAGA.Slave
Disco Fever - Ipec Elite	D/Disco Fever - Ipec Elite	A-Demos:D/DiscoFever/DiscoFever.Slave
Divine Inspiration - Goldfire	D/Divine Inspiration - Goldf	A-Demos:D/DivineInspiration/DivineInspiration.Slave
Dizzy Tunes 1 - Noiseless,The Silents	D/Dizzy Tunes 1 - Noiseless.	A-Demos:D/DizzyTunes/DizzyTunes.Slave
Dizzy Tunes 2 - Spaceballs,noiseless	D/Dizzy Tunes 2 - Spaceballs	A-Demos:D/DizzyTunes2/DizzyTunes2.Slave
The Dog's Cogs - Nerve Axis AGA	T/The Dogs Cogs - Nerve Axis	A-Demos:D/DogsCogsAGA/DogsCogsAGA.Slave
Don Martin - Hypnosis	D/Don Martin - Hypnosis	A-Demos:D/DonMartinMusicDisk/DonMartinMusicDisk.Slave
Don't Panic - LSD	D/Dont Panic - LSD	A-Demos:D/DontPanic/DontPanic.Slave
D.O.S - Andromeda	D/D.O.S - Andromeda	A-Demos:D/DOS/DOS.slave
Do the Bartman - Freehand	D/Do the Bartman - Freehand	A-Demos:D/DoTheBartman/DoTheBartman.Slave
Double Intro Part1 - Vega Intro	D/Double Intro Part1 - Vega	A-Demos:D/DoubleIntro/DoubleIntro.Slave
Dragon Lord - Alfaforce	D/Dragon Lord - Alfaforce	A-Demos:D/DragonLord/DragonLord.Slave
Dream Trippin' - Digital	D/Dream Trippin - Digital	A-Demos:D/DreamTrippin/DreamTrippin.Slave
Drums & Pipes - Surprise!Productions,Tristar & Red Sector Inc.	D/Drums Pipes - SurpriseProd	A-Demos:D/Drums&Pipes/Drums&Pipes.Slave
Drums & Reverbs - Chryseis	D/Drums Reverbs - Chryseis	A-Demos:D/Drums&Reverbs/Drums&Reverbs.Slave
The drunk desert demo - Paradox Demo	T/The drunk desert demo - Pa	A-Demos:D/DrunkDesertDemo/DrunkDesertDemo.Slave
Dynamo - Orion	D/Dynamo - Orion	A-Demos:D/Dynamo/Dynamo.Slave
Dyspepsia - Analogy	D/Dyspepsia - Analogy	A-Demos:D/Dyspepsia/Dyspepsia.Slave
Eargasm Tunes - The Silents	E/Eargasm Tunes - The Silent	A-Demos:E/EargasmTunes/EargasmTunes.Slave
Earwig - Infect	E/Earwig - Infect	A-Demos:E/Earwig/Earwig.Slave
E.C.E.S. slideshow - Rebels AGA	E/E.C.E.S. slideshow - Rebel	A-Demos:E/ECESSlideshow/ECESSlideshow.slave
Ecliptica - TRSI	E/Ecliptica - TRSI	A-Demos:E/Ecliptica/Ecliptica.Slave
Electric Sound 3 - The Goonies 2041	E/Electric Sound 3 - The Goo	A-Demos:E/ElectricSound3/ElectricSound3.Slave
Electrons At Work - The Electronic Knights	E/Electrons At Work - The El	A-Demos:E/ElectronsAtWork/ElectronsAtWork.Slave
Elysium - Sanity	E/Elysium - Sanity	A-Demos:E/Elysium/Elysium.Slave
Emptyhead - Rednex AGA	E/Emptyhead - Rednex AGA	A-Demos:E/EmptyheadAGA/EmptyheadAGA.Slave
End of maloy - The Silents	E/End of maloy - The Silents	A-Demos:E/EndOfMaloy/EndOfMaloy.Slave
End Of The Misery - Sagazity	E/End Of The Misery - Sagazi	A-Demos:E/EndOfTheMisery/EndOfTheMisery.Slave
The Engine - Ramses AGA	T/The Engine - Ramses AGA	A-Demos:E/EngineAGA/EngineAGA.Slave
Enigma - Phenomena	E/Enigma - Phenomena	A-Demos:E/Enigma/Enigma.slave
Enjoy the Silents - The Silents	E/Enjoy the Silents - The Si	A-Demos:E/EnjoyTheSilents/EnjoyTheSilents.Slave
Epilepsia - Amnesia	E/Epilepsia - Amnesia	A-Demos:E/Epilepsia/Epilepsia.Slave
Epilepsia 2 - Amnesia	E/Epilepsia 2 - Amnesia	A-Demos:E/Epilepsia2/Epilepsia2.Slave
Erazorhead - Razor 1911	E/Erazorhead - Razor 1911	A-Demos:E/Erazorhead/Erazorhead.Slave
The triple breasted whore of eroticon 6 - Leeds Spreading Division	T/The triple breasted whore	A-Demos:E/Eroticon6/Eroticon6.slave
Essential Beats Volume 3 - Quote	E/Essential Beats Volume 3 -	A-Demos:E/EssentialBeats3/EssentialBeats3.Slave
Essential Classics - Nova	E/Essential Classics - Nova	A-Demos:E/EssentialClassics/EssentialClassics.Slave
Estprobal Mastic - Imagine	E/Estprobal Mastic - Imagine	A-Demos:E/EstprobalMastic/EstprobalMastic.Slave
Exage 1 - Burning Independence	E/Exage 1 - Burning Independ	A-Demos:E/Exage/Exage.Slave
XS Excess - Reflex (Amiga)	X/XS Excess - Reflex Amiga	A-Demos:E/Excess/Excess.Slave
Experiment - Ram Jam	E/Experiment - Ram Jam	A-Demos:E/Experiment/Experiment.Slave
Explorer - Delight AGA	E/Explorer - Delight AGA	A-Demos:E/ExplorerAGA/ExplorerAGA.slave
Expressions - Timecircle	E/Expressions - Timecircle	A-Demos:E/Expressions/Expressions.Slave
Extemporized - Digital	E/Extemporized - Digital	A-Demos:E/Extemporized/Extemporized.Slave
Extension - Pygmy projects	E/Extension - Pygmy projects	A-Demos:E/Extension/Extension.slave
Face another day - Razor 1911	F/Face another day - Razor 1	A-Demos:F/FaceAnotherDay/FaceAnotherDay.Slave
Faktory - Virtual Dreams,Fairlight AGA	F/Faktory - Virtual Dreams.F	A-Demos:F/FaktoryAGA/FaktoryAGA.Slave
Falling Up - Analog	F/Falling Up - Analog	A-Demos:F/FallingUp/FallingUp.Slave
The Fantastic Art Of Tobias Richter - Crusaders	T/The Fantastic Art Of Tobia	A-Demos:F/FantasticArt/FantasticArt.slave
Fantastic Dream - Saints	F/Fantastic Dream - Saints	A-Demos:F/FantasticDream/FantasticDream.Slave
Fantastic Pix 1 - Venom	F/Fantastic Pix 1 - Venom	A-Demos:F/FantasticPixVol1/FantasticPixVol1.Slave
Faster Than Hell - World Federation of Mad Hackers	F/Faster Than Hell - World F	A-Demos:F/FasterThanHell/FasterThanHell.Slave
Finlandia - Dual Crew,Complex	F/Finlandia - Dual Crew.Comp	A-Demos:F/Finlandia/Finlandia.Slave
First demo - Exact Demo	F/First demo - Exact Demo	A-Demos:F/FirstDemo/FirstDemo.Slave
Flower Power - Anarchy	F/Flower Power - Anarchy	A-Demos:F/FlowerPower/FlowerPower.Slave
Follow Me - Red Sector Inc.	F/Follow Me - Red Sector Inc	A-Demos:F/FollowMe/FollowMe.Slave
Fool's gold - Sanity	F/Fools gold - Sanity	A-Demos:F/FoolsGold/FoolsGold.Slave
Forgotten - Mirage	F/Forgotten - Mirage	A-Demos:F/Forgotten/Forgotten.Slave
Fractal Tunes - Midnightsun	F/Fractal Tunes - Midnightsu	A-Demos:F/FractalTunes/FractalTunes.Slave
Friday at Eight - Polka brothers AGA	F/Friday at Eight - Polka br	A-Demos:F/FridayAtEightAGA/FridayAtEightAGA.Slave
Fullmoon - Virtual Dreams,Fairlight AGA	F/Fullmoon - Virtual Dreams.	A-Demos:F/FullMoonAGA/FullMoonAGA.Slave
Future Synthetix - Anthrox	F/Future Synthetix - Anthrox	A-Demos:F/FutureSynthetix/FutureSynthetix.Slave
Gate To Hell - Technology	G/Gate To Hell - Technology	A-Demos:G/GateToHell/GateToHell.Slave
Gathering 91 - Byterapers,Scoopex	G/Gathering 91 - Byterapers.	A-Demos:G/Gathering91Slideshow/Gathering91Slideshow.Slave
Gathering 1993 Partyslides - Majic 12	G/Gathering 1993 Partyslides	A-Demos:G/Gathering93Slideshow/Gathering93Slideshow.Slave
Gen4 Demo - Dragons Demo	G/Gen4 Demo - Dragons Demo	A-Demos:G/Gen4Demo/Gen4Demo.Slave
Gevalia - Polka brothers AGA	G/Gevalia - Polka brothers A	A-Demos:G/Gevalia/Gevalia.Slave
Gigademo 3 - Triangle,The Gang Demo3	G/Gigademo 3 - Triangle.The	A-Demos:G/GigaDemo3/GigaDemo3.Slave
Gladiator music - Cryptoburners	G/Gladiator music - Cryptobu	A-Demos:G/GladiatorMusic/GladiatorMusic.Slave
Global Trash - The Silents	G/Global Trash - The Silents	A-Demos:G/GlobalTrash/GlobalTrash.Slave
Gloom Party Invitation - Gloom	G/Gloom Party Invitation - G	A-Demos:G/GloomPartyInvitation/GloomPartyInvitation.slave
Glow - The Black Lotus AGA	G/Glow - The Black Lotus AGA	A-Demos:G/GlowAGA/GlowAGA.slave
Goa - The Black Lotus AGA	G/Goa - The Black Lotus AGA	A-Demos:G/GoaAGA/GoaAGA.Slave
Grapevine Megamix - LSD	G/Grapevine Megamix - LSD	A-Demos:G/GrapevineMegamix/GrapevineMegamix.slave
Great Bytes In Fire - Cyberiad	G/Great Bytes In Fire - Cybe	A-Demos:G/GreatBytesInFire/GreatBytesInFire.Slave
Greatest Hits - Cult	G/Greatest Hits - Cult	A-Demos:G/GreatestHits/GreatestHits.Slave
Groovy! - Lemon.	G/Groovy - Lemon.	A-Demos:G/Groovy/Groovy.slave
Groovy Jives #3 - Relay	G/Groovy Jives 3 - Relay	A-Demos:G/GroovyJives3/GroovyJives3.slave
Guardian Dragon - Kefrens	G/Guardian Dragon - Kefrens	A-Demos:G/GuardianDragon/GuardianDragon.slave
Guardian Dragon 2 - Kefrens	G/Guardian Dragon 2 - Kefren	A-Demos:G/GuardianDragon2/GuardianDragon2.slave
Hail the Engineer - Jetset	H/Hail the Engineer - Jetset	A-Demos:H/HailTheEngineer/HailTheEngineer.Slave
Hallucinations and dreams - preview - Katharsis	H/Hallucinations and dreams	A-Demos:H/Hallu&DreamsPrvKatharsis/Hallu&DreamsPrvKatharsis.Slave
Hallucinations and Dreams - Union	H/Hallucinations and Dreams 	A-Demos:H/Hallucinations&Dreams/Hallucinations&Dreams.Slave
Hammer - Amaze	H/Hammer - Amaze	A-Demos:H/Hammer/Hammer.Slave
Hardcore - Anarchy	H/Hardcore - Anarchy	A-Demos:H/Hardcore/Hardcore.slave
Hardwired - Crionics,The Silents	H/Hardwired - Crionics.The S	A-Demos:H/Hardwired/Hardwired.Slave
Harmagedon - Infect AGA	H/Harmagedon - Infect AGA	A-Demos:H/HarmagedonAGA/HarmagedonAGA.Slave
Here we are - Awake	H/Here we are - Awake	A-Demos:H/HereWeAre/HereWeAre.Slave
Hexadecimal perfection - Action Direct	H/Hexadecimal perfection - A	A-Demos:H/HexadecimalPerfection/HexadecimalPerfection.slave
Highway 1930 - Fraxion	H/Highway 1930 - Fraxion	A-Demos:H/Highway1930/Highway1930.Slave
His Master's Noise - Mahoney & Kaktus	H/His Masters Noise - Mahone	A-Demos:H/HisMastersNoise/HisMastersNoise.slave
Hit Collection 1 - Commando	H/Hit Collection 1 - Command	A-Demos:H/HitCollection1/HitCollection1.Slave
Hit Fido - Kgb	H/Hit Fido - Kgb	A-Demos:H/HitFido/HitFido.Slave
Hit the Road - Flash Production	H/Hit the Road - Flash Produ	A-Demos:H/HitTheRoad/HitTheRoad.Slave
Hollywood Poker Slide - The Light Circle	H/Hollywood Poker Slide - Th	A-Demos:H/HollywoodPokerSlide/HollywoodPokerSlide.Slave
Honeycomb - Tristar & Red Sector Inc.	H/Honeycomb - Tristar Red Se	A-Demos:H/HoneyComb/HoneyComb.Slave
Hot Music 1 - Ram Jam	H/Hot Music 1 - Ram Jam	A-Demos:H/HotMusic1/HotMusic1.Slave
Hot Music 3 - Ram Jam	H/Hot Music 3 - Ram Jam	A-Demos:H/HotMusic3/HotMusic3.Slave
Hot Music 4 - Ram Jam	H/Hot Music 4 - Ram Jam	A-Demos:H/HotMusic4/HotMusic4.Slave
House Music - Vision	H/House Music - Vision	A-Demos:H/HouseMusic/HouseMusic.Slave
How To Skin A Cat - Melon Dezign	H/How To Skin A Cat - Melon	A-Demos:H/How2SkinACat/How2SkinACat.slave
Human Target - Melon Dezign	H/Human Target - Melon Dezig	A-Demos:H/HumanTarget/HumanTarget.Slave
The Hunt for 7th October - Cryptoburners	T/The Hunt for 7th October -	A-Demos:H/HuntFor7thOctober/HuntFor7thOctober.Slave
Hymn 633 - Damage	H/Hymn 633 - Damage	A-Demos:H/Hymn633/Hymn633.slave
Hymns From The Bible 3 - Arcane	H/Hymns From The Bible 3 - A	A-Demos:H/HymnsFromTheBible3/HymnsFromTheBible3.Slave
Ice - The Silents	I/Ice - The Silents	A-Demos:I/Ice/Ice.slave
Ilex - Mystic AGA	I/Ilex - Mystic AGA	A-Demos:I/IlexAGA/IlexAGA.Slave
Ilyad - Alcatraz AGA	I/Ilyad - Alcatraz AGA	A-Demos:I/IlyadAGA/IlyadAGA.Slave
Impulse 2 - Tilt,Old Bulls	I/Impulse 2 - Tilt.Old Bulls	A-Demos:I/Impulse2/Impulse2.slave
Infinite Dreams - Lunatics	I/Infinite Dreams - Lunatics	A-Demos:I/InfiniteDreamsLunatics/InfiniteDreamsLunatics.Slave
In Full Affect - WildFire Crew	I/In Full Affect - WildFire	A-Demos:I/InFullAffect/InFullAffect.Slave
InnerShip - Pussy	I/InnerShip - Pussy	A-Demos:I/InnershipPussy/InnershipPussy.slave
Inner-Vision - Dreamdealers	I/Inner-Vision - Dreamdealer	A-Demos:I/Innervision/Innervision.Slave
Inspiration is gone - Kefrens	I/Inspiration is gone - Kefr	A-Demos:I/InspirationIsGone/InspirationIsGone.Slave
Inspiration is none - Anarchy	I/Inspiration is none - Anar	A-Demos:I/InspirationIsNone/InspirationIsNone.Slave
Interference - Sanity	I/Interference - Sanity	A-Demos:I/Interference/Interference.Slave
Interspace - Phenomena	I/Interspace - Phenomena	A-Demos:I/Interspace/Interspace.Slave
In the kitchen - Anarchy	I/In the kitchen - Anarchy	A-Demos:I/InTheKitchen/InTheKitchen.Slave
Kick Off - The Code Killers	K/Kick Off - The Code Killer	A-Demos:I/IntroCodeKillers/IntroCodeKillers.slave
Intro? Dentro? Mentro? Demo? - The Silents Demo	I/Intro Dentro Mentro Demo -	A-Demos:I/IntroDentroMentroDemo/IntroDentroMentroDemo.Slave
Iraq - Animators Demo	I/Iraq - Animators Demo	A-Demos:I/IraqDemo/IraqDemo.Slave
Iso - Scoopex AGA	I/Iso - Scoopex AGA	A-Demos:I/IsoAGA/IsoAGA.slave
It's Just the Beginning - Paragon (Amiga)	I/Its Just the Beginning - P	A-Demos:I/ItsJustTheBeginning/ItsJustTheBeginning.Slave
I've got the power - Alcatraz	I/Ive got the power - Alcatr	A-Demos:I/IveGotThePower/IveGotThePower.Slave
Jehova goes Hitech - Voice	J/Jehova goes Hitech - Voice	A-Demos:J/JehovaGoesHitech/JehovaGoesHitech.Slave
Jesterday - Sanity	J/Jesterday - Sanity	A-Demos:J/Jesterday/Jesterday.slave
Jesus on E's - LSD ES	J/Jesus on Es - LSD ES	A-Demos:J/JesusOnEs/JesusOnEs.slave
Jesus was a demomaker - Ramses AGA	J/Jesus was a demomaker - Ra	A-Demos:J/JesusWasADemomakerAGA/JesusWasADemomakerAGA.Slave
Jiggle It - Palace IT	J/Jiggle It - Palace IT	A-Demos:J/JiggleIt/JiggleIt.Slave
Jochen Hippel Sound Demo - Axis Demo	J/Jochen Hippel Sound Demo -	A-Demos:J/JochenHippelSoundDemo/JochenHippelSoundDemo.Slave
Joyride - Phenomena	J/Joyride - Phenomena	A-Demos:J/Joyride/Joyride.Slave
Juggler - Eric Graham	J/Juggler - Eric Graham	A-Demos:J/Juggler/Juggler.Slave
Jukebox - Kefrens	J/Jukebox - Kefrens	A-Demos:J/Jukebox/Jukebox.Slave
Jungle Mania - The Jungle Command	J/Jungle Mania - The Jungle	A-Demos:J/JungleMania/JungleMania.slave
Just For Your Ears - Brainwave	J/Just For Your Ears - Brain	A-Demos:J/Just4YourEars/Just4YourEars.Slave
Kakburk - Strangers	K/Kakburk - Strangers	A-Demos:K/Kakburk/Kakburk.Slave
Kaos Theory - Pendle Europa	K/Kaos Theory - Pendle Europ	A-Demos:K/KaosTheory/KaosTheory.Slave
Kefmania - Cult	K/Kefmania - Cult	A-Demos:K/Kefmania/Kefmania.Slave
Kerygma - Wizzcat	K/Kerygma - Wizzcat	A-Demos:K/Kerygma/Kerygma.Slave
Kiwi Crap - Reality	K/Kiwi Crap - Reality	A-Demos:K/KiwiCrap/KiwiCrap.Slave
Krest Mass Leftovers - Anarchy	K/Krest Mass Leftovers - Ana	A-Demos:K/KrestMassLeftovers/KrestMassLeftovers.slave
Kuglepølen - Static bytes	K/Kugleplen - Static bytes	A-Demos:K/Kuglepoelen/Kuglepoelen.Slave
The Last Sun - Ackerlight	T/The Last Sun - Ackerlight	A-Demos:L/LastSun/LastSun.Slave
Legalise It... - Anarchy IT	L/Legalise It... - Anarchy I	A-Demos:L/LegaliseIt/LegaliseIt.Slave
Legalize It 2 - Anarchy	L/Legalize It 2 - Anarchy	A-Demos:L/LegalizeIt2/LegalizeIt2.slave
Legoland - Desire	L/Legoland - Desire	A-Demos:L/Legoland/Legoland.Slave
Lethal Exit - Digital	L/Lethal Exit - Digital	A-Demos:L/LethalExit/LethalExit.Slave
Lethal Frequency - Aspect	L/Lethal Frequency - Aspect	A-Demos:L/LethalFrequency/LethalFrequency.Slave
Linus - Palace	L/Linus - Palace	A-Demos:L/Linus/Linus.Slave
Lithium - Awesome	L/Lithium - Awesome	A-Demos:L/Lithium/Lithium.Slave
Loony Tunes #1 - Divine	L/Loony Tunes 1 - Divine	A-Demos:L/LoonyTunes/LoonyTunes.Slave
Lost World - Balance	L/Lost World - Balance	A-Demos:L/LostWorld/LostWorld.Slave
Love & Anarchy - Carillon	L/Love Anarchy - Carillon	A-Demos:L/Love&Anarchy/Love&Anarchy.slave
Love - Virtual Dreams,Fairlight AGA	L/Love - Virtual Dreams.Fair	A-Demos:L/LoveAGA/LoveAGA.Slave
Love songs - Crime Devils	L/Love songs - Crime Devils	A-Demos:L/Lovesongs/Lovesongs.Slave
Madness - Anarchy	M/Madness - Anarchy	A-Demos:M/Madness/Madness.Slave
Madness 2 - The Search for Sanity - Anarchy	M/Madness 2 - The Search for	A-Demos:M/Madness2/Madness2.Slave
Maestro Jams vol.1 - Kefrens	M/Maestro Jams vol.1 - Kefre	A-Demos:M/MaestroJamsVol1/MaestroJamsVol1.Slave
Magnetic Dreams - Digital	M/Magnetic Dreams - Digital	A-Demos:M/MagneticDreams/MagneticDreams.Slave
Magnum Icetro - Depth	M/Magnum Icetro - Depth	A-Demos:M/MagnumIcetro/MagnumIcetro.Slave
Makaveli - Essence AGA	M/Makaveli - Essence AGA	A-Demos:M/MakaveliAGA/MakaveliAGA.Slave
Manic Raves II - Logic Systems	M/Manic Raves II - Logic Sys	A-Demos:M/ManicRaves2/ManicRaves2.slave
Marchewki - Alchemy	M/Marchewki - Alchemy	A-Demos:M/Marchewki/Marchewki.Slave
Masterpieces - Kefrens	M/Masterpieces - Kefrens	A-Demos:M/Masterpieces/Masterpieces.Slave
Materialized - Cryptoburners	M/Materialized - Cryptoburne	A-Demos:M/Materialized/Materialized.Slave
Maximum Overdrive 2 - Rage AGA	M/Maximum Overdrive 2 - Rage	A-Demos:M/MaximumOverdrive2/MaximumOverdrive2.Slave
Maximum velocity - The Silents	M/Maximum velocity - The Sil	A-Demos:M/MaximumVelocity/MaximumVelocity.Slave
Mean Break Machine 2 - Tetragon	M/Mean Break Machine 2 - Tet	A-Demos:M/MeanBreakMachine2/MeanBreakMachine2.Slave
Megablast - Rebels	M/Megablast - Rebels	A-Demos:M/Megablast/Megablast.Slave
Megademo 2 - Alcatraz	M/Megademo 2 - Alcatraz	A-Demos:M/Megademo2Alcatraz/Megademo2Alcatraz.slave
Megademo 2 - Bass	M/Megademo 2 - Bass	A-Demos:M/Megademo2Bass/Megademo2Bass.slave
Megademo 2 - Bronx	M/Megademo 2 - Bronx	A-Demos:M/Megademo2Bronx/Megademo2Bronx.Slave
Megademo 2 - Budbrain	M/Megademo 2 - Budbrain	A-Demos:M/Megademo2Budbrain/Megademo2Budbrain.slave
Megademo 2 - Darkness	M/Megademo 2 - Darkness	A-Demos:M/Megademo2Darkness/Megademo2Darkness.slave
Megademo 2 - Dexion	M/Megademo 2 - Dexion	A-Demos:M/Megademo2Dexion/Megademo2Dexion.Slave
Megademo 2 - Disorder	M/Megademo 2 - Disorder	A-Demos:M/Megademo2Disorder/Megademo2Disorder.Slave
Megademo 2 - Megaforce	M/Megademo 2 - Megaforce	A-Demos:M/Megademo2Megaforce/Megademo2Megaforce.Slave
Megademo 2 - Northstar	M/Megademo 2 - Northstar	A-Demos:M/Megademo2NorthStar/Megademo2NorthStar.Slave
Megademo 2 - Rebels	M/Megademo 2 - Rebels	A-Demos:M/Megademo2Rebels/Megademo2Rebels.Slave
Megademo 2 - Scoopex	M/Megademo 2 - Scoopex	A-Demos:M/Megademo2Scoopex/Megademo2Scoopex.Slave
Megademo 2 - Vision	M/Megademo 2 - Vision	A-Demos:M/Megademo2Vision/Megademo2Vision.Slave
Megademo 2 - Vortex 42	M/Megademo 2 - Vortex 42	A-Demos:M/Megademo2Vortex42/Megademo2Vortex42.Slave
Megademo 3 - Alcatraz	M/Megademo 3 - Alcatraz	A-Demos:M/Megademo3Alcatraz/Megademo3Alcatraz.Slave
Megademo 4 - Kefrens,7up Crew	M/Megademo 4 - Kefrens.7up C	A-Demos:M/Megademo4Kefrens&7UpCrew/Megademo4Kefrens&7UpCrew.Slave
Megademo 4 - Vision	M/Megademo 4 - Vision	A-Demos:M/Megademo4Vision/Megademo4Vision.slave
Megademo 5 - Kefrens	M/Megademo 5 - Kefrens	A-Demos:M/Megademo5Kefrens/Megademo5Kefrens.Slave
Megademo 6 - Kefrens	M/Megademo 6 - Kefrens	A-Demos:M/Megademo6Kefrens/Megademo6Kefrens.Slave
Megademo 7 - Kefrens	M/Megademo 7 - Kefrens	A-Demos:M/Megademo7Kefrens/Megademo7Kefrens.Slave
Megademo 8 - Kefrens	M/Megademo 8 - Kefrens	A-Demos:M/Megademo8Kefrens/Megademo8Kefrens.Slave
Megademo - Acme (Amiga)	M/Megademo - Acme Amiga	A-Demos:M/MegademoAcme/MegademoAcme.Slave
Megademo - Alcatraz	M/Megademo - Alcatraz	A-Demos:M/MegademoAlcatraz/MegademoAlcatraz.Slave
Megademo - Avenger	M/Megademo - Avenger	A-Demos:M/MegademoAvenger/MegademoAvenger.slave
Megademo - Bass	M/Megademo - Bass	A-Demos:M/MegademoBass/MegademoBass.slave
Megademo - Beastie Boys	M/Megademo - Beastie Boys	A-Demos:M/MegademoBeastieBoys/MegademoBeastieBoys.slave
Megademo - Budbrain	M/Megademo - Budbrain	A-Demos:M/MegademoBudbrain/MegademoBudbrain.Slave
Megademo - Cult	M/Megademo - Cult	A-Demos:M/MegademoCult/MegademoCult.Slave
Megademo - Darkness	M/Megademo - Darkness	A-Demos:M/MegademoDarkness/MegademoDarkness.slave
Megademo - Deathstar	M/Megademo - Deathstar	A-Demos:M/MegademoDeathstar/MegademoDeathstar.slave
Megademo - Dexion	M/Megademo - Dexion	A-Demos:M/MegademoDexion/MegademoDexion.Slave
Megademo - Digitech	M/Megademo - Digitech	A-Demos:M/MegademoDigitech&IBB/MegademoDigitech&IBB.Slave
Megademo - Dragons	M/Megademo - Dragons	A-Demos:M/MegademoDragons/MegademoDragons.slave
Megademo - Electronic Artists	M/Megademo - Electronic Arti	A-Demos:M/MegademoEOA/MegademoEOA.Slave
Megademo - Excellence	M/Megademo - Excellence	A-Demos:M/MegademoExcellence/MegademoExcellence.Slave
Megademo - Freedom Force	M/Megademo - Freedom Force	A-Demos:M/MegademoFreedomForce/MegademoFreedomForce.slave
Megademo - Goldfire	M/Megademo - Goldfire	A-Demos:M/MegademoGoldfire/MegademoGoldfire.Slave
Megademo - Humanoids	M/Megademo - Humanoids	A-Demos:M/MegademoHumanoids/MegademoHumanoids.Slave
Megademo - Intuition	M/Megademo - Intuition	A-Demos:M/MegademoIntuition/MegademoIntuition.Slave
Megademo - IT IT	M/Megademo - IT IT	A-Demos:M/MegademoIt/MegademoIt.Slave
Megademo - Joy	M/Megademo - Joy	A-Demos:M/MegademoJoy&MGF&TJC/MegademoJoy&MGF&TJC.slave
Megademo One - Katharsis	M/Megademo One - Katharsis	A-Demos:M/MegademoKatharsis/MegademoKatharsis.Slave
Megademo - Mad monks	M/Megademo - Mad monks	A-Demos:M/MegademoMadMonks/MegademoMadMonks.Slave
Megademo one - Manowar	M/Megademo one - Manowar	A-Demos:M/MegademoManowar/MegademoManowar.Slave
Megademo - Megaforce	M/Megademo - Megaforce	A-Demos:M/MegademoMegaforce/MegademoMegaforce.Slave
Megademo - Northstar	M/Megademo - Northstar	A-Demos:M/MegademoNorthStar/MegademoNorthStar.Slave
Megademo - Phenomena	M/Megademo - Phenomena	A-Demos:M/MegademoPhenomena/MegademoPhenomena.slave
Megademo - Possessed	M/Megademo - Possessed	A-Demos:M/MegademoPossessed/MegademoPossessed.Slave
Megademo - Powerslaves	M/Megademo - Powerslaves	A-Demos:M/MegademoPowerslaves/MegademoPowerslaves.Slave
Megademo - Precise	M/Megademo - Precise	A-Demos:M/MegademoPrecise/MegademoPrecise.Slave
Megademo - Predators	M/Megademo - Predators	A-Demos:M/MegademoPredators/MegademoPredators.Slave
Megademo - Pseudoplast	M/Megademo - Pseudoplast	A-Demos:M/MegademoPseudoPlast/MegademoPseudoPlast.Slave
Megademo - Red Sector Inc.	M/Megademo - Red Sector Inc.	A-Demos:M/MegademoRedSectorInc/MegademoRedSectorInc.Slave
Megademo - Royal Amiga Force	M/Megademo - Royal Amiga For	A-Demos:M/MegademoRoyalAmigaForce/MegademoRoyalAmigaForce.slave
Megademo - Scoopex	M/Megademo - Scoopex	A-Demos:M/MegademoScoopex/MegademoScoopex.Slave
Megademo - Software Of Sweden	M/Megademo - Software Of Swe	A-Demos:M/MegademoSOS/MegademoSOS.slave
Megademo - Static bytes	M/Megademo - Static bytes	A-Demos:M/MegademoStaticBytes/MegademoStaticBytes.Slave
Megademo - The link	M/Megademo - The link	A-Demos:M/MegademoTheLink/MegademoTheLink.Slave
Megademo - United Forces	M/Megademo - United Forces	A-Demos:M/MegademoUnitedForces/MegademoUnitedForces.Slave
Megademo - Vermin	M/Megademo - Vermin	A-Demos:M/MegademoVermin/MegademoVermin.Slave
Megademo - Vision	M/Megademo - Vision	A-Demos:M/MegademoVision/MegademoVision.Slave
Megademo - Vortex 42	M/Megademo - Vortex 42	A-Demos:M/MegademoVortex42/MegademoVortex42.Slave
Megademo - Zeus	M/Megademo - Zeus	A-Demos:M/MegademoZeus/MegademoZeus.slave
Megamix 1 - Royal Amiga Force	M/Megamix 1 - Royal Amiga Fo	A-Demos:M/MegaMix1/MegaMix1.Slave
Megamix 2 - The Pumpin' Track - Royal Amiga Force	M/Megamix 2 - The Pumpin Tra	A-Demos:M/MegaMix2/MegaMix2.slave
Megamix 3 - Royal Amiga Force	M/Megamix 3 - Royal Amiga Fo	A-Demos:M/MegaMix3/MegaMix3.Slave
Khalaan - Inner City	K/Khalaan - Inner City	A-Demos:M/MegaTraxVol1/MegaTraxVol1.Slave
Scoopex Melodies - Scoopex	S/Scoopex Melodies - Scoopex	A-Demos:M/Melodies/Melodies.Slave
Memorial Songs - Alcatraz	M/Memorial Songs - Alcatraz	A-Demos:M/MemorialSongs/MemorialSongs.Slave
Mental Hangover - Scoopex	M/Mental Hangover - Scoopex	A-Demos:M/MentalHangover/MentalHangover.Slave
Merry Melodies - Relay	M/Merry Melodies - Relay	A-Demos:M/MerryMelodies/MerryMelodies.Slave
Mesmerized - Pure Metal Coders	M/Mesmerized - Pure Metal Co	A-Demos:M/Mesmerized/Mesmerized.Slave
Metal - Bundies	M/Metal - Bundies	A-Demos:M/Metal&Lace/Metal&Lace.Slave
Metal Melissa The Pisser - Animators	M/Metal Melissa The Pisser -	A-Demos:M/MetalMelissaThePisser/MetalMelissaThePisser.Slave
Metamorphosis - Brainstorm	M/Metamorphosis - Brainstorm	A-Demos:M/Metamorphosis/Metamorphosis.Slave
Miami Vice Theme - Swiss Cracking Association	M/Miami Vice Theme - Swiss C	A-Demos:M/MiamiViceTheme/MiamiViceTheme.Slave
Mi-Cro Con-Cept - The Crusaders	M/Mi-Cro Con-Cept - The Crus	A-Demos:M/MicroConcept/MicroConcept.slave
Mina Omistan - Movement AGA	M/Mina Omistan - Movement AG	A-Demos:M/MinaOmistanAGA/MinaOmistanAGA.Slave
Mindriot - Andromeda	M/Mindriot - Andromeda	A-Demos:M/MindRiot/MindRiot.Slave
Mini Megademo - Doom	M/Mini Megademo - Doom	A-Demos:M/MiniMegademoDoom/MiniMegademoDoom.Slave
Mini Soundbox I - Shadow Light,Level 4	M/Mini Soundbox I - Shadow L	A-Demos:M/MiniSoundbox1/MiniSoundbox1.Slave
Mini Soundbox II - Shadow Light,Level 4	M/Mini Soundbox II - Shadow	A-Demos:M/MiniSoundbox2/MiniSoundbox2.Slave
Mini Soundbox III - Shadow Light,Level 4	M/Mini Soundbox III - Shadow	A-Demos:M/MiniSoundbox3/MiniSoundbox3.Slave
Minor Defects - Grace	M/Minor Defects - Grace	A-Demos:M/MinorDefects/MinorDefects.Slave
Miracle Sounds - Miracle	M/Miracle Sounds - Miracle	A-Demos:M/MiracleSounds1/MiracleSounds1.Slave
Mirror - Andromeda	M/Mirror - Andromeda	A-Demos:M/Mirror/Mirror.Slave
Misery Dentro 2 - Masque,Tristar & Red Sector Inc.	M/Misery Dentro 2 - Masque.T	A-Demos:M/MiseryDentro2/MiseryDentro2.Slave
Mixolydian - End of Century 1999	M/Mixolydian - End of Centur	A-Demos:M/Mixolydian/Mixolydian.Slave
Mobile Destination Unknown - Spaceballs	M/Mobile Destination Unknown	A-Demos:M/MobileDestinationUnknown/MobileDestinationUnknown.slave
Moin Jungs - Doctor Mabuse Orgasm Crackings	M/Moin Jungs - Doctor Mabuse	A-Demos:M/MoinJungs/MoinJungs.Slave
Monoxide - Vanish	M/Monoxide - Vanish	A-Demos:M/Monoxide/Monoxide.Slave
Morbid Visions - Cyberiad	M/Morbid Visions - Cyberiad	A-Demos:M/MorbidVisions/MorbidVisions.Slave
Morbid Visions II - Carillon & Cyberiad	M/Morbid Visions II - Carill	A-Demos:M/MorbidVisions2/MorbidVisions2.Slave
Morbid visions 3 - Carillon & Cyberiad,Complex	M/Morbid visions 3 - Carillo	A-Demos:M/MorbidVisions3/MorbidVisions3.Slave
More than music - Alcatraz	M/More than music - Alcatraz	A-Demos:M/MoreThanMusic/MoreThanMusic.Slave
Motion (origin 2) - Bomb AGA	M/Motion origin 2 - Bomb AGA	A-Demos:M/MotionAGA/MotionAGA.slave
Mr. Monkey - Rebels AGA	M/Mr. Monkey - Rebels AGA	A-Demos:M/MrMonkeyAGA/MrMonkeyAGA.Slave
Multica - Andromeda	M/Multica - Andromeda	A-Demos:M/Multica/Multica.slave
Multi Demo - Amaze	M/Multi Demo - Amaze	A-Demos:M/Multidemo/Multidemo.Slave
Multi Megamix - Kefrens	M/Multi Megamix - Kefrens	A-Demos:M/MultiMegamix/MultiMegamix.slave
Multi Megamix 2 - Kefrens	M/Multi Megamix 2 - Kefrens	A-Demos:M/MultiMegamix2/MultiMegamix2.slave
Multi Megamix 3 - Kefrens	M/Multi Megamix 3 - Kefrens	A-Demos:M/MultiMegamix3/MultiMegamix3.Slave
Musabox #2 - Falcons	M/Musabox 2 - Falcons	A-Demos:M/Musabox/Musabox.Slave
Musabox #2 - Falcons	M/Musabox 2 - Falcons 	A-Demos:M/Musabox2/Musabox2.Slave
Museum - Alcatraz	M/Museum - Alcatraz	A-Demos:M/Museum/Museum.Slave
Musical Rabbit - Carillon & Cyberiad	M/Musical Rabbit - Carillon	A-Demos:M/MusicalRabbit/MusicalRabbit.Slave
Musical Secrets - Zite	M/Musical Secrets - Zite	A-Demos:M/MusicalSecrets/MusicalSecrets.Slave
Musication Vol.1 - Absolute!	M/Musication Vol.1 - Absolut	A-Demos:M/Musication/Musication.Slave
Musicbox 3 - Gate	M/Musicbox 3 - Gate	A-Demos:M/Musicbox3/Musicbox3.Slave
Music Box - Copyride	M/Music Box - Copyride	A-Demos:M/MusicBoxCopyride/MusicBoxCopyride.Slave
Musicbox - Exodus	M/Musicbox - Exodus	A-Demos:M/MusicBoxExodus/MusicBoxExodus.Slave
Music Collection 4 - Level 4	M/Music Collection 4 - Level	A-Demos:M/MusicCollection4Zarch/MusicCollection4Zarch.Slave
Music Collection - Exocet	M/Music Collection - Exocet	A-Demos:M/MusicCollectionExocet/MusicCollectionExocet.Slave
Music Collection - Katharsis	M/Music Collection - Kathars	A-Demos:M/MusicCollectionKatharsis/MusicCollectionKatharsis.Slave
Music Compacting 2 - Alpha Flight 1970,Zylon	M/Music Compacting 2 - Alpha	A-Demos:M/MusicCompacting2/MusicCompacting2.slave
Music Compilation - Random Access	M/Music Compilation - Random	A-Demos:M/MusicCompilation/MusicCompilation.Slave
Music Demo - Deform	M/Music Demo - Deform	A-Demos:M/MusicDemoDeform/MusicDemoDeform.Slave
Techno music disk vol. 1 - Virna	T/Techno music disk vol. 1 -	A-Demos:M/MusicDiscVol1DiskNet/MusicDiscVol1DiskNet.Slave
Music Disk 1 - The 81st Track	M/Music Disk 1 - The 81st Tr	A-Demos:M/MusicDisk181stTrack/MusicDisk181stTrack.Slave
Adam McCrory Music Disk 1 - Adam McCrory	A/Adam McCrory Music Disk 1	A-Demos:M/MusicDisk1AdamMcCrory/MusicDisk1AdamMcCrory.Slave
Musicdisk 1 - Alcatraz	M/Musicdisk 1 - Alcatraz	A-Demos:M/MusicDisk1Alcatraz/MusicDisk1Alcatraz.Slave
Music Disk - Bass	M/Music Disk - Bass	A-Demos:M/MusicDisk1Bass/MusicDisk1Bass.slave
Music-Disk 1 - D-Mob	M/Music-Disk 1 - D-Mob	A-Demos:M/MusicDisk1DMob/MusicDisk1DMob.Slave
Musicdisk #1 - The Fantasy Force	M/Musicdisk 1 - The Fantasy	A-Demos:M/MusicDisk1FantasyForce/MusicDisk1FantasyForce.Slave
MusicDisk #1 - IKS	M/MusicDisk 1 - IKS	A-Demos:M/MusicDisk1IKS/MusicDisk1IKS.Slave
Musicdisk 1 - Mahoney & Kaktus	M/Musicdisk 1 - Mahoney Kakt	A-Demos:M/MusicDisk1Mahoney&Kaktus/MusicDisk1Mahoney&Kaktus.Slave
Music Disk 1 - Prologic	M/Music Disk 1 - Prologic	A-Demos:M/MusicDisk1Prologic/MusicDisk1Prologic.Slave
Musicdisk 1 - Vega	M/Musicdisk 1 - Vega	A-Demos:M/MusicDisk1Vega/MusicDisk1Vega.Slave
Musicdisk 2 - Fantasy Force	M/Musicdisk 2 - Fantasy Forc	A-Demos:M/MusicDisk2/MusicDisk2.Slave
Music Disk 2 - The 81st Track	M/Music Disk 2 - The 81st Tr	A-Demos:M/MusicDisk281stTrack/MusicDisk281stTrack.Slave
Musicdisk 2 - Darkness	M/Musicdisk 2 - Darkness	A-Demos:M/MusicDisk2Darkness/MusicDisk2Darkness.Slave
Music Madness 2 - Ipec Elite	M/Music Madness 2 - Ipec Eli	A-Demos:M/MusicDisk2Elite/MusicDisk2Elite.Slave
MusicDisk #2 - IKS	M/MusicDisk 2 - IKS	A-Demos:M/MusicDisk2IKS/MusicDisk2IKS.Slave
Musicdisk 2 - Vega	M/Musicdisk 2 - Vega	A-Demos:M/MusicDisk2Vega/MusicDisk2Vega.Slave
Mega Musicdisk III - D-Mob	M/Mega Musicdisk III - D-Mob	A-Demos:M/MusicDisk3DMob/MusicDisk3DMob.Slave
Musicdisk IV - D-Mob	M/Musicdisk IV - D-Mob	A-Demos:M/MusicDisk4DMob/MusicDisk4DMob.Slave
Musicdisk 4 - Vega	M/Musicdisk 4 - Vega	A-Demos:M/MusicDisk4Vega/MusicDisk4Vega.Slave
Music Disk 6 - Ram Jam	M/Music Disk 6 - Ram Jam	A-Demos:M/MusicDisk6RamJam/MusicDisk6RamJam.Slave
Musicdisk - Action Force	M/Musicdisk - Action Force	A-Demos:M/MusicDiskActionForce/MusicDiskActionForce.slave
Walkman & Othon Musicdisk - Armada,IT IT	W/Walkman Othon Musicdisk -	A-Demos:M/MusicDiskArmada&It/MusicDiskArmada&It.Slave
Musicdisk - Orix,aspect	M/Musicdisk - Orix.aspect	A-Demos:M/MusicDiskAspect&Orix/MusicDiskAspect&Orix.Slave
MusicDisk - Cryptic	M/MusicDisk - Cryptic	A-Demos:M/MusicDiskCryptic/MusicDiskCryptic.Slave
Music Disk - Dexion	M/Music Disk - Dexion	A-Demos:M/MusicDiskDexion/MusicDiskDexion.Slave
Music Disk - Dreamscape	M/Music Disk - Dreamscape	A-Demos:M/MusicDiskDreamscape/MusicDiskDreamscape.Slave
Musicdisk - Escape	M/Musicdisk - Escape	A-Demos:M/MusicDiskEscape/MusicDiskEscape.Slave
Musicdisk - Inzzest	M/Musicdisk - Inzzest	A-Demos:M/MusicDiskInzzest/MusicDiskInzzest.Slave
Music Disk - Ipec Elite	M/Music Disk - Ipec Elite	A-Demos:M/MusicDiskIpecElite/MusicDiskIpecElite.Slave
MusicDisk - Tardex	M/MusicDisk - Tardex	A-Demos:M/MusicDiskTardex/MusicDiskTardex.Slave
Music pack 1 - Thrust	M/Music pack 1 - Thrust	A-Demos:M/MusicDiskThrust/MusicDiskThrust.Slave
Music Dream 1 - Phenomena	M/Music Dream 1 - Phenomena	A-Demos:M/MusicDream1/MusicDream1.Slave
Music Dream 2 - Phenomena	M/Music Dream 2 - Phenomena	A-Demos:M/MusicDream2/MusicDream2.Slave
Music for fools - Ghost	M/Music for fools - Ghost	A-Demos:M/MusicForFools/MusicForFools.Slave
Musicland - Brainstorm	M/Musicland - Brainstorm	A-Demos:M/Musicland/Musicland.slave
Musicland 2 - Brainstorm	M/Musicland 2 - Brainstorm	A-Demos:M/Musicland2/Musicland2.slave
Music Madness - Ipec Elite	M/Music Madness - Ipec Elite	A-Demos:M/MusicMadness/MusicMadness.Slave
Music Madness 2 - Ipec Elite	M/Music Madness 2 - Ipec  V2	A-Demos:M/MusicMadness2/MusicMadness2.Slave
Music Megademo 2 - Ghostbusters Demo2	M/Music Megademo 2 - Ghostbu	A-Demos:M/MusicMegaDemo2/MusicMegaDemo2.Slave
Music party 1990 - Cryptoburners	M/Music party 1990 - Cryptob	A-Demos:M/MusicParty1990/MusicParty1990.slave
Music Rip #2 - Silicon League	M/Music Rip 2 - Silicon Leag	A-Demos:M/MusicRip2/MusicRip2.Slave
Music Rip3 - Spreadpoint	M/Music Rip3 - Spreadpoint	A-Demos:M/MusicRip3/MusicRip3.Slave
The enemies musics III - The Enemies	T/The enemies musics III - T	A-Demos:M/Musics3/Musics3.Slave
Music Selector - Deadlock	M/Music Selector - Deadlock	A-Demos:M/MusicSelector/MusicSelector.Slave
Music With a Message - Magnetic Fields	M/Music With a Message - Mag	A-Demos:M/MusicWithAMessage/MusicWithAMessage.Slave
The Musique Disk - Accession	T/The Musique Disk - Accessi	A-Demos:M/MusiqueDisk/MusiqueDisk.Slave
Muzak compacting 1 - Alpha Flight 1970,Mindwarp	M/Muzak compacting 1 - Alpha	A-Demos:M/MuzakCompacting1/MuzakCompacting1.Slave
Muzaks Disk 1 - Securitate	M/Muzaks Disk 1 - Securitate	A-Demos:M/MuzaksDisk1/MuzaksDisk1.Slave
Muzzax 1 - Byterapers	M/Muzzax 1 - Byterapers	A-Demos:M/Muzzax1/Muzzax1.slave
Muzzax 2 - Byterapers	M/Muzzax 2 - Byterapers	A-Demos:M/Muzzax2/Muzzax2.slave
Muzzax 3 - Byterapers	M/Muzzax 3 - Byterapers	A-Demos:M/Muzzax3/Muzzax3.Slave
Muzzax 4 - Byterapers	M/Muzzax 4 - Byterapers	A-Demos:M/Muzzax4/Muzzax4.Slave
Muzzax 5 - Byterapers	M/Muzzax 5 - Byterapers	A-Demos:M/Muzzax5/Muzzax5.Slave
Muzzax 6 - Byterapers	M/Muzzax 6 - Byterapers	A-Demos:M/Muzzax6/Muzzax6.Slave
Muzzax 7 - Byterapers	M/Muzzax 7 - Byterapers	A-Demos:M/Muzzax7/Muzzax7.Slave
My Room - Fairlight	M/My Room - Fairlight	A-Demos:M/MyRoom/MyRoom.Slave
Negative FX - Reality	N/Negative FX - Reality	A-Demos:N/NegativeFX/NegativeFX.Slave
Neural Assault - Rage	N/Neural Assault - Rage	A-Demos:N/NeuralAssault/NeuralAssault.Slave
New age - Ram Jam	N/New age - Ram Jam	A-Demos:N/NewAge/NewAge.Slave
Nexus-7 - Andromeda AGA	N/Nexus-7 - Andromeda AGA	A-Demos:N/Nexus7AGA/Nexus7AGA.Slave
Nightshade's Harmony - Ecstasy	N/Nightshades Harmony - Ecst	A-Demos:N/NightshadesHarmony/NightshadesHarmony.Slave
No Brain - No Pain! (megademo) - Flash Production	N/No Brain - No Pain megadem	A-Demos:N/NoBrainNoPainFlashProd/NoBrainNoPainFlashProd.Slave
No Brain No Pain - Paradise	N/No Brain No Pain - Paradis	A-Demos:N/NoBrainNoPainParadise/NoBrainNoPainParadise.Slave
Non Stop Music - Jungle Command	N/Non Stop Music - Jungle Co	A-Demos:N/NonStopMusic/NonStopMusic.Slave
Nonterraqueous - Alarm	N/Nonterraqueous - Alarm	A-Demos:N/Nonterraqueous/Nonterraqueous.Slave
Nop - Muffbusters AGA	N/Nop - Muffbusters AGA	A-Demos:N/NopAGA/NopAGA.Slave
Not AGAin! - S.C.A.L.A. AGA	N/Not AGAin - S.C.A.L.A. AGA	A-Demos:N/NotAgain/NotAgain.slave
No Tech - Bass	N/No Tech - Bass	A-Demos:N/NoTech/NoTech.Slave
Nugget - The Black Lotus	N/Nugget - The Black Lotus	A-Demos:N/Nugget/Nugget.Slave
Numb - Movement AGA	N/Numb - Movement AGA	A-Demos:N/NumbAGA/NumbAGA.Slave
NUMERIC - Profecy	N/NUMERIC - Profecy	A-Demos:N/Numeric/Numeric.Slave
NUMERIC 2 - Profecy	N/NUMERIC 2 - Profecy	A-Demos:N/Numeric2/Numeric2.Slave
NUMERIC 3 - Profecy	N/NUMERIC 3 - Profecy	A-Demos:N/Numeric3/Numeric3.Slave
Oasis - Stellar AGA	O/Oasis - Stellar AGA	A-Demos:O/OasisAGA/OasisAGA.Slave
Oblique Infinity - Goldfire	O/Oblique Infinity - Goldfir	A-Demos:O/ObliqueInfinity/ObliqueInfinity.Slave
Obvious Disaster - Phenomena	O/Obvious Disaster - Phenome	A-Demos:O/ObviousDisaster/ObviousDisaster.Slave
Odeon - Solution	O/Odeon - Solution	A-Demos:O/Odeon/Odeon.Slave
Ode To Ramon - Digital Force	O/Ode To Ramon - Digital For	A-Demos:O/OdeToRamon/OdeToRamon.Slave
Ode to Ramon 2 - The Digital Force	O/Ode to Ramon 2 - The Digit	A-Demos:O/OdeToRamon2/OdeToRamon2.Slave
Odysounds 2 - Odyssey	O/Odysounds 2 - Odyssey	A-Demos:O/OdySounds2/OdySounds2.Slave
Odyssey - Alcatraz	O/Odyssey - Alcatraz	A-Demos:O/Odyssey/Odyssey.Slave
Old Tunes - Chrome	O/Old Tunes - Chrome	A-Demos:O/OldTunes/OldTunes.Slave
One Day On Mars - Exile	O/One Day On Mars - Exile	A-Demos:O/OneDayOnMars/OneDayOnMars.Slave
One Stone -Sport Aid- - Quest	O/One Stone -Sport Aid- - Qu	A-Demos:O/OneStone/OneStone.slave
Optical Dreams - Addict	O/Optical Dreams - Addict	A-Demos:O/OpticalDreams/OpticalDreams.Slave
Orgasm - Old Bulls	O/Orgasm - Old Bulls	A-Demos:O/Orgasm/Orgasm.Slave
Origin - Complex AGA	O/Origin - Complex AGA	A-Demos:O/OriginAGA/OriginAGA.slave
Ottifanten - Thrust	O/Ottifanten - Thrust	A-Demos:O/Ottifanten/Ottifanten.Slave
Ottifanten 2 - Thrust	O/Ottifanten 2 - Thrust	A-Demos:O/Ottifanten2/Ottifanten2.Slave
Our definition of a boombastic demo style - Rebels	O/Our definition of a boomba	A-Demos:O/OurDefOfBoombastic/OurDefOfBoombastic.slave
Overdose - Delight	O/Overdose - Delight	A-Demos:O/Overdose/Overdose.Slave
Overload - Jetset	O/Overload - Jetset	A-Demos:O/Overload/Overload.Slave
Overload 2 - Skid Row,Jetset	O/Overload 2 - Skid Row.Jets	A-Demos:O/Overload2/Overload2.Slave
Pack van pee #1 - Jetset	P/Pack van pee 1 - Jetset	A-Demos:P/PackVanPee1/PackVanPee1.Slave
Pack van pee #3 - Jetset	P/Pack van pee 3 - Jetset	A-Demos:P/PackVanPee3/PackVanPee3.Slave
Panic - Voices of Energy - Alcatraz	P/Panic - Voices of Energy -	A-Demos:P/PanicVoicesOfEnergy/PanicVoicesOfEnergy.Slave
Paralytic noises - Inzzest	P/Paralytic noises - Inzzest	A-Demos:P/ParalyticNoises/ParalyticNoises.Slave
The Party II Slideshow - Decnite	T/The Party II Slideshow - D	A-Demos:P/Party2Slideshow/Party2Slideshow.Slave
Pastel Vanilla - Nova	P/Pastel Vanilla - Nova	A-Demos:P/PastelVanilla/PastelVanilla.slave
Peace in the Gulf - Animators	P/Peace in the Gulf - Animat	A-Demos:P/PeaceInTheGulf/PeaceInTheGulf.slave
Pee Wee - Complex AGA	P/Pee Wee - Complex AGA	A-Demos:P/PeeWeeAGA/PeeWeeAGA.Slave
Picture Book - Axis AGA	P/Picture Book - Axis AGA	A-Demos:P/PictureBookAGA/PictureBookAGA.Slave
The pink circle - Arcane	T/The pink circle - Arcane	A-Demos:P/PinkCircle/PinkCircle.Slave
Pixeled Pleasures - Them	P/Pixeled Pleasures - Them	A-Demos:P/PixeledPleasures/PixeledPleasures.Slave
Pixel Nation - Defjam	P/Pixel Nation - Defjam	A-Demos:P/PixelNation/PixelNation.Slave
Hoi Saga Demo I - Planet Groove - Team hoi AGA	H/Hoi Saga Demo I - Planet G	A-Demos:P/PlanetGrooveAGA/PlanetGrooveAGA.slave
Planet M. - Melon Dezign AGA	P/Planet M. - Melon Dezign A	A-Demos:P/PlanetMAGA/PlanetMAGA.Slave
Plastic Passion - UPFRONT	P/Plastic Passion - UPFRONT	A-Demos:P/PlasticPassion/PlasticPassion.Slave
Playbyte Commercial - Shining	P/Playbyte Commercial - Shin	A-Demos:P/PlaybyteCommercial/PlaybyteCommercial.Slave
Point blank - Andromeda	P/Point blank - Andromeda	A-Demos:P/PointBlank/PointBlank.Slave
Power and Agony - Trackers	P/Power and Agony - Trackers	A-Demos:P/PowerAndAgony/PowerAndAgony.Slave
Powertrax - The Light Circle	P/Powertrax - The Light Circ	A-Demos:P/Powertrax/Powertrax.Slave
The Prey - Polka brothers AGA	T/The Prey - Polka brothers	A-Demos:P/PreyAGA/PreyAGA.Slave
Megademo - Mirage	M/Megademo - Mirage	A-Demos:P/Prime90/Prime90.Slave
Prism - Melon Dezign	P/Prism - Melon Dezign	A-Demos:P/Prism/Prism.Slave
Project Beat - Crusaders	P/Project Beat - Crusaders	A-Demos:P/ProjectBeat/ProjectBeat.Slave
Project Techno - Quartz	P/Project Techno - Quartz	A-Demos:P/ProjectTechno/ProjectTechno.Slave
Pro S.I.A.K. - Flying Cows Inc.	P/Pro S.I.A.K. - Flying Cows	A-Demos:P/ProSIAK/ProSIAK.slave
Psychedelic - Virtual Dreams,Fairlight AGA	P/Psychedelic - Virtual Drea	A-Demos:P/PsychedelicAGA/PsychedelicAGA.Slave
Psychic - Effect	P/Psychic - Effect	A-Demos:P/Psychic/Psychic.Slave
Psygnosis Musical Picture Disc #1 - Psygnosis & S.R.S	P/Psygnosis Musical Picture	A-Demos:P/PsygnosisMusicPictureDisc/PsygnosisMusicPictureDisc.Slave
Public Attack - Cult	P/Public Attack - Cult	A-Demos:P/PublicAttack/PublicAttack.slave
Puggs in Space - Dionysus	P/Puggs in Space - Dionysus	A-Demos:P/PuggsInSpace/PuggsInSpace.Slave
The Punisher - Digital	T/The Punisher - Digital	A-Demos:P/Punisher/Punisher.Slave
Purple - Warfalcons	P/Purple - Warfalcons	A-Demos:P/Purple/Purple.Slave
QED - Talent	Q/QED - Talent	A-Demos:Q/QED/QED.Slave
QED 2 - Talent AGA	Q/QED 2 - Talent AGA	A-Demos:Q/QED2AGA/QED2AGA.Slave
Que - The Black Lotus AGA	Q/Que - The Black Lotus AGA	A-Demos:Q/QueAGA/QueAGA.Slave
Quick Musique - Oxygen	Q/Quick Musique - Oxygen	A-Demos:Q/QuickMusique/QuickMusique.Slave
Rainheart Project - BAD COMPANY	R/Rainheart Project - BAD CO	A-Demos:R/RainheartProject/RainheartProject.slave
Rampage - The Electronic Knights	R/Rampage - The Electronic K	A-Demos:R/Rampage/Rampage.Slave
Rap is Crap - Taipan	R/Rap is Crap - Taipan	A-Demos:R/RapIsCrap/RapIsCrap.Slave
Raverance - Cyclone	R/Raverance - Cyclone	A-Demos:R/Raverance/Raverance.slave
Ray of Hope - Majic 12	R/Ray of Hope - Majic 12	A-Demos:R/RayOfHope/RayOfHope.Slave
Ray of hope 2 - Majic 12	R/Ray of hope 2 - Majic 12	A-Demos:R/RayOfHope2/RayOfHope2.slave
Raytraced Dreams - Old Bulls	R/Raytraced Dreams - Old Bul	A-Demos:R/RaytracedDreams/RaytracedDreams.Slave
Real - Complex AGA	R/Real - Complex AGA	A-Demos:R/RealAGA/RealAGA.Slave
Real Empathy - Virtual	R/Real Empathy - Virtual	A-Demos:R/RealEmpathy/RealEmpathy.Slave
Reflex - Liquid	R/Reflex - Liquid	A-Demos:R/Reflex/Reflex.slave
Revenge - Fraxion	R/Revenge - Fraxion	A-Demos:R/Revenge/Revenge.Slave
Revolutions - Amaze	R/Revolutions - Amaze	A-Demos:R/Revolutions/Revolutions.Slave
Rhythm Device - Energy	R/Rhythm Device - Energy	A-Demos:R/RhythmDevice/RhythmDevice.Slave
Rhythm Nation - The Lost Boys	R/Rhythm Nation - The Lost B	A-Demos:R/RhythmNation/RhythmNation.Slave
Rink A Dink - Lemon.	R/Rink A Dink - Lemon.	A-Demos:R/RinkADink/RinkADink.Slave
Rink a Dink: REDUX - Lemon.	R/Rink a Dink REDUX - Lemon.	A-Demos:R/RinkADinkRedux/RinkADinkRedux.Slave
Rock Box 1 - Avoid	R/Rock Box 1 - Avoid	A-Demos:R/RockBox1/RockBox1.Slave
RockBox2 - Avoid	R/RockBox2 - Avoid	A-Demos:R/RockBox2/RockBox2.Slave
Rolling - Omega Machine Designers,Ringard	R/Rolling - Omega Machine De	A-Demos:R/Rolling/Rolling.Slave
Roots v2.0 - Sanity	R/Roots v2.0 - Sanity	A-Demos:R/Roots2/Roots2.Slave
Roots v2.0 - Sanity AGA	R/Roots v2.0 - Sanity AGA	A-Demos:R/Roots2AGA/Roots2AGA.Slave
Roots - Sanity AGA	R/Roots - Sanity AGA	A-Demos:R/RootsAGA/RootsAGA.slave
Roswell - NFA AGA	R/Roswell - NFA AGA	A-Demos:R/Roswell/Roswell.Slave
Route 66 - D-Mob	R/Route 66 - D-Mob	A-Demos:R/Route66/Route66.Slave
Royal Music - The Magic Guild	R/Royal Music - The Magic Gu	A-Demos:R/RoyalMusic/RoyalMusic.Slave
Royal Music 2 - The Magic Guild	R/Royal Music 2 - The Magic	A-Demos:R/RoyalMusic2/RoyalMusic2.Slave
Rubbish - Amega Industries	R/Rubbish - Amega Industries	A-Demos:R/Rubbish/Rubbish.Slave
S - Skarla AGA	S/S - Skarla AGA	A-Demos:S/SAGA/SAGA.Slave
Sane Sound - Academy	S/Sane Sound - Academy	A-Demos:S/SaneSounds/SaneSounds.slave
ScrewBalls - Phenomena	S/ScrewBalls - Phenomena	A-Demos:S/Screwballs/Screwballs.Slave
SCR Musax 2 - Scrapers	S/SCR Musax 2 - Scrapers	A-Demos:S/SCRMusax2/SCRMusax2.Slave
Seduction - Complex AGA	S/Seduction - Complex AGA	A-Demos:S/SeductionAGA/SeductionAGA.Slave
Seeing is believing - Anarchy	S/Seeing is believing - Anar	A-Demos:S/SeeingIsBelieving/SeeingIsBelieving.Slave
Semi93 invitation - Manitou	S/Semi93 invitation - Manito	A-Demos:S/Semi93Invitation/Semi93Invitation.Slave
A-Sensation - Ramses AGA	A/A-Sensation - Ramses AGA	A-Demos:S/SensationAGA/SensationAGA.Slave
Sensenmann - United Forces	S/Sensenmann - United Forces	A-Demos:S/Sensenmann/Sensenmann.Slave
Sequential - Andromeda	S/Sequential - Andromeda	A-Demos:S/Sequential/Sequential.slave
Seven seas - Andromeda	S/Seven seas - Andromeda	A-Demos:S/SevenSeas/SevenSeas.Slave
Seven Sins - Scoopex	S/Seven Sins - Scoopex	A-Demos:S/SevenSins/SevenSins.Slave
Sexvens - Morelove	S/Sexvens - Morelove	A-Demos:S/Sexvens/Sexvens.slave
ShadowFire - Exact	S/ShadowFire - Exact	A-Demos:S/ShadowFire/ShadowFire.Slave
Shaft7 - Bomb AGA	S/Shaft7 - Bomb AGA	A-Demos:S/Shaft7AGA/Shaft7AGA.Slave
Shakka Lakka - Digital AGA	S/Shakka Lakka - Digital AGA	A-Demos:S/ShakkaLakkaAGA/ShakkaLakkaAGA.Slave
Shed Tears - Ozone	S/Shed Tears - Ozone	A-Demos:S/ShedTears/ShedTears.Slave
Sigh - Old Bulls	S/Sigh - Old Bulls	A-Demos:S/Sigh/Sigh.Slave
Silicon Graphics 2 - World Federation of Mad Hackers AGA	S/Silicon Graphics 2 - World	A-Demos:S/SiliconGraphics2AGA/SiliconGraphics2AGA.Slave
Simpsons Demo - Decay	S/Simpsons Demo - Decay	A-Demos:S/Simpsons/Simpsons.Slave
Smau 92 Music Disk - Nightfall	S/Smau 92 Music Disk - Night	A-Demos:S/Smau92MusicDisk/Smau92MusicDisk.Slave
Snap! - Rebels	S/Snap - Rebels	A-Demos:S/Snap/Snap.slave
Soft Movie - Genocide	S/Soft Movie - Genocide	A-Demos:S/SOFTMovie/SOFTMovie.Slave
Software - World Federation of Mad Hackers	S/Software - World Federatio	A-Demos:S/Software/Software.Slave
Songs of Infinity - Pointless	S/Songs of Infinity - Pointl	A-Demos:S/SongsOfInfinity/SongsOfInfinity.Slave
Songs rack - Ram Jam AGA	S/Songs rack - Ram Jam AGA	A-Demos:S/SongsRackAGA/SongsRackAGA.Slave
Sonical Fantasia - Equinox	S/Sonical Fantasia - Equinox	A-Demos:S/SonicalFantasia/SonicalFantasia.Slave
Sonic Attack - Dual Crew & Shining	S/Sonic Attack - Dual Crew S	A-Demos:S/SonicAttack/SonicAttack.Slave
Smell Of Shit (S.O.S) - Melon Dezign	S/Smell Of Shit S.O.S - Melo	A-Demos:S/SOS/SOS.Slave
Soulkitchen - The Silents AGA	S/Soulkitchen - The Silents	A-Demos:S/SoulKitchenAGA/SoulKitchenAGA.slave
Sound and Vision - Rebels	S/Sound and Vision - Rebels	A-Demos:S/SoundAndVision/SoundAndVision.Slave
Sound Atax Vol. 1 - Magnetic Fields	S/Sound Atax Vol. 1 - Magnet	A-Demos:S/SoundAtaxVol1/SoundAtaxVol1.Slave
Sound Atax Vol. 2 - Magnetic Fields	S/Sound Atax Vol. 2 - Magnet	A-Demos:S/SoundAtaxVol2/SoundAtaxVol2.Slave
Sound Atax Vol. 3 - Magnetic Fields	S/Sound Atax Vol. 3 - Magnet	A-Demos:S/SoundAtaxVol3/SoundAtaxVol3.Slave
Sound Barrier - Balance	S/Sound Barrier - Balance	A-Demos:S/SoundBarrier/SoundBarrier.Slave
Soundbox 2 - Alpha Flight 1970,Genesis (Alpha Flight)	S/Soundbox 2 - Alpha Flight	A-Demos:S/Soundbox2/Soundbox2.Slave
Sound De Light - Software Of Sweden	S/Sound De Light - Software	A-Demos:S/SoundDeLight/SoundDeLight.slave
Sounddemo - Syndicate	S/Sounddemo - Syndicate	A-Demos:S/SoundDemoSyndicate/SoundDemoSyndicate.Slave
Sound Disk 1 - Mygon	S/Sound Disk 1 - Mygon	A-Demos:S/SoundDisk1/SoundDisk1.Slave
Sound Disk 2 - Mygon	S/Sound Disk 2 - Mygon	A-Demos:S/SoundDisk2/SoundDisk2.Slave
Sound Disk - Zenith	S/Sound Disk - Zenith	A-Demos:S/SoundDiskPossessed/SoundDiskPossessed.Slave
Sound Disk - Zenith	S/Sound Disk - Zenith 	A-Demos:S/SoundDiskZenith/SoundDiskZenith.slave
Sound engine - Absence	S/Sound engine - Absence	A-Demos:S/SoundEngine/SoundEngine.Slave
Sound Engine 2 - Absence	S/Sound Engine 2 - Absence	A-Demos:S/SoundEngine2/SoundEngine2.Slave
Sound Erection - Shining 8	S/Sound Erection - Shining 8	A-Demos:S/SoundErection/SoundErection.Slave
Sound Highlights 1 - Timex	S/Sound Highlights 1 - Timex	A-Demos:S/SoundHighlights1/SoundHighlights1.Slave
Sound Mania 2 - Pussy	S/Sound Mania 2 - Pussy	A-Demos:S/SoundMania2Pussy/SoundMania2Pussy.Slave
Sound of Music 7 - Cave	S/Sound of Music 7 - Cave	A-Demos:S/SoundOfMusic7/SoundOfMusic7.slave
Sound of Silents - The Silents	S/Sound of Silents - The Sil	A-Demos:S/SoundOfSilents/SoundOfSilents.Slave
Soundquest 1 - Quest	S/Soundquest 1 - Quest	A-Demos:S/SoundQuest1/SoundQuest1.Slave
Sound Quest #2 - Quest	S/Sound Quest 2 - Quest	A-Demos:S/SoundQuest2/SoundQuest2.Slave
Soundrevolution 6 - Celtic	S/Soundrevolution 6 - Celtic	A-Demos:S/Soundrevolution6/Soundrevolution6.Slave
Sounds of Gnome - Mahoney & Kaktus,Northstar	S/Sounds of Gnome - Mahoney	A-Demos:S/SoundsOfGnome/SoundsOfGnome.slave
Soundtracker Injury 2 - Electronic Artists	S/Soundtracker Injury 2 - El	A-Demos:S/SoundtrackerInjury2/SoundtrackerInjury2.Slave
Soundtracker Injury 3 - Electronic Artists	S/Soundtracker Injury 3 - El	A-Demos:S/SoundtrackerInjury3/SoundtrackerInjury3.Slave
Soundtrip - Shadows	S/Soundtrip - Shadows	A-Demos:S/Soundtrip/Soundtrip.Slave
Sound Vision - Reflect	S/Sound Vision - Reflect	A-Demos:S/SoundVision/SoundVision.Slave
Sozzled somersault - The Silents	S/Sozzled somersault - The S	A-Demos:S/SozzledSomersault/SozzledSomersault.Slave
Spaced Out Vol. 1 - Magnetic Fields	S/Spaced Out Vol. 1 - Magnet	A-Demos:S/SpacedOutVol1/SpacedOutVol1.Slave
Spaced Out Vol. 2 - Magnetic Fields	S/Spaced Out Vol. 2 - Magnet	A-Demos:S/SpacedOutVol2/SpacedOutVol2.Slave
Spaceship - Doctor Mabuse Orgasm Crackings	S/Spaceship - Doctor Mabuse	A-Demos:S/Spaceship/Spaceship.Slave
Spasmolytic - Spaceballs	S/Spasmolytic - Spaceballs	A-Demos:S/Spasmolytic/Spasmolytic.slave
Spellcheck - Andromeda	S/Spellcheck - Andromeda	A-Demos:S/Spellcheck/Spellcheck.Slave
Tuneshow IV (Spherical Dreams) - The Acoustic Revolution	T/Tuneshow IV Spherical Drea	A-Demos:S/SphericalDreams/SphericalDreams.Slave
Sploosh - Anthrox	S/Sploosh - Anthrox	A-Demos:S/Sploosh/Sploosh.Slave
P.o.n.d (sploosh 1.5) - Anthrox	P/P.o.n.d sploosh 1.5 - Anth	A-Demos:S/Sploosh15Pond/Sploosh15Pond.Slave
Spring Melodies - Anarchy	S/Spring Melodies - Anarchy	A-Demos:S/SpringMelodies/SpringMelodies.slave
Stag 1 - BNK-Team	S/Stag 1 - BNK-Team	A-Demos:S/Stag1/Stag1.slave
Stag 2 - The BNK Team	S/Stag 2 - The BNK Team	A-Demos:S/Stag2/Stag2.slave
Stag 3 - BNK-Team	S/Stag 3 - BNK-Team	A-Demos:S/Stag3/Stag3.slave
Stag 4 - BNK-Team	S/Stag 4 - BNK-Team	A-Demos:S/Stag4/Stag4.slave
Stag 5 - BNK-Team	S/Stag 5 - BNK-Team	A-Demos:S/Stag5/Stag5.slave
Stag 6 - BNK-Team	S/Stag 6 - BNK-Team	A-Demos:S/Stag6/Stag6.slave
Stag EXTRA - BNK-Team	S/Stag EXTRA - BNK-Team	A-Demos:S/StagExtra/StagExtra.slave
Stag 1 - BNK-Team	S/Stag 1 - BNK-Team 	A-Demos:S/StagSeries/StagSeries.slave
Stateline - Complex	S/Stateline - Complex	A-Demos:S/Stateline/Stateline.Slave
State of the Art - Spaceballs	S/State of the Art - Spaceba	A-Demos:S/StateOfTheArt/StateOfTheArt.Slave
Static Chaos - The Silents	S/Static Chaos - The Silents	A-Demos:S/StaticChaos/StaticChaos.Slave
Status quo - Mad elks	S/Status quo - Mad elks	A-Demos:S/StatusQuo/StatusQuo.Slave
Status quo - Mad elks FAST	S/Status quo - Mad elks FAST	A-Demos:S/StatusQuoFast/StatusQuoFast.Slave
Stereo Sounds - Eon	S/Stereo Sounds - Eon	A-Demos:S/StereoSounds/StereoSounds.Slave
Steve Vizard Demo - Decay	S/Steve Vizard Demo - Decay	A-Demos:S/SteveVizard/SteveVizard.Slave
Stop Fascism - Alcatraz,Interactive	S/Stop Fascism - Alcatraz.In	A-Demos:S/StopFascism/StopFascism.Slave
Strange Dream #1 - Willow (Amiga)	S/Strange Dream 1 - Willow A	A-Demos:S/StrangeMusic1/StrangeMusic1.Slave
Strange Music 2 - Strange	S/Strange Music 2 - Strange	A-Demos:S/StrangeMusic2/StrangeMusic2.Slave
Strange Music 3 - Strange	S/Strange Music 3 - Strange	A-Demos:S/StrangeMusic3/StrangeMusic3.Slave
Subliminal Vision - Bass	S/Subliminal Vision - Bass	A-Demos:S/SubliminalVision/SubliminalVision.Slave
Substance - Quartex,Alliance design	S/Substance - Quartex.Allian	A-Demos:S/Substance/Substance.Slave
Subtle shades - Nuance	S/Subtle shades - Nuance	A-Demos:S/SubtleShades/SubtleShades.Slave
Sumea - Virtual Dreams,Fairlight AGA	S/Sumea - Virtual Dreams.Fai	A-Demos:S/SumeaAGA/SumeaAGA.Slave
Sun - TRSI AGA	S/Sun - TRSI AGA	A-Demos:S/SunAGA/SunAGA.Slave
Sunset glow - Thrust	S/Sunset glow - Thrust	A-Demos:S/SunsetGlow/SunsetGlow.Slave
Sweet music - Crusaders	S/Sweet music - Crusaders	A-Demos:S/SweetMusic/SweetMusic.slave
Sweet Revenge - Decay	S/Sweet Revenge - Decay	A-Demos:S/SweetRevenge/SweetRevenge.Slave
Sweltering Forest - Apocalypse Bay	S/Sweltering Forest - Apocal	A-Demos:S/SwelteringForest/SwelteringForest.Slave
Switchback - Rebels AGA	S/Switchback - Rebels AGA	A-Demos:S/SwitchbackAGA/SwitchbackAGA.Slave
Synthesis - Underground	S/Synthesis - Underground	A-Demos:S/Synthesis/Synthesis.Slave
Synthesis - Network AGA	S/Synthesis - Network AGA	A-Demos:S/SynthesisNetworkAGA/SynthesisNetworkAGA.slave
Synthetic Power - Cave	S/Synthetic Power - Cave	A-Demos:S/SyntheticPower/SyntheticPower.Slave
Synthetic Vibes - Quartz	S/Synthetic Vibes - Quartz	A-Demos:S/SyntheticVibes/SyntheticVibes.Slave
System violation - Anarchy	S/System violation - Anarchy	A-Demos:S/SystemViolation/SystemViolation.Slave
TAG - Jetset,Skid Row	T/TAG - Jetset.Skid Row	A-Demos:T/Tag/Tag.Slave
TAG - Jetset,Skid Row AGA	T/TAG - Jetset.Skid Row AGA	A-Demos:T/TagAGA/TagAGA.Slave
Talktime 1 - Essence	T/Talktime 1 - Essence	A-Demos:T/Talktime1/Talktime1.Slave
Taylor Dayne: Tell It To My Heart - Algotech Software	T/Taylor Dayne Tell It To My	A-Demos:T/TaylorDayneTITMH/TaylorDayneTITMH.Slave
The Long Dark Teatime Of The Soul - Leeds Spreading Division	T/The Long Dark Teatime Of T	A-Demos:T/Teatime/TeaTime.slave
Technological Death - Mad elks	T/Technological Death - Mad	A-Demos:T/TechnologicalDeath/TechnologicalDeath.slave
Technomania - Shining 8	T/Technomania - Shining 8	A-Demos:T/Technomania/Technomania.Slave
Technomania 2 - Shining 8	T/Technomania 2 - Shining 8	A-Demos:T/Technomania2/Technomania2.Slave
Techno Trance - Bastards	T/Techno Trance - Bastards	A-Demos:T/TechnoTrance/TechnoTrance.Slave
Techno Trance 3 - Bastards	T/Techno Trance 3 - Bastards	A-Demos:T/TechnoTrance3/TechnoTrance3.Slave
Techno Warrior - LSD	T/Techno Warrior - LSD	A-Demos:T/TechnoWarrior/TechnoWarrior.slave
TechTech - Sodan,Magician 42	T/TechTech - Sodan.Magician	A-Demos:T/Techtech/Techtech.Slave
Tekkno Bert -The Final Collapse- - Wildfire	T/Tekkno Bert -The Final Col	A-Demos:T/Tekknobert/Tekknobert.Slave
Tera Tunes - Alpha Flight	T/Tera Tunes - Alpha Flight	A-Demos:T/TeraTunes/TeraTunes.Slave
Tera Tunes II - Team-X	T/Tera Tunes II - Team-X	A-Demos:T/TeraTunes2/TeraTunes2.Slave
Terminal fuckup - Sanity	T/Terminal fuckup - Sanity	A-Demos:T/TerminalFuckup/TerminalFuckup.Slave
The Terminator - Status OK	T/The Terminator - Status OK	A-Demos:T/Terminator/Terminator.Slave
Testament - Katharsis	T/Testament - Katharsis	A-Demos:T/Testament/Testament.Slave
Thalion Sound demo - Thalion Demo	T/Thalion Sound demo - Thali	A-Demos:T/ThalionSoundDemo/ThalionSoundDemo.slave
Third dimension - Cryptoburners	T/Third dimension - Cryptobu	A-Demos:T/ThirdDimension/ThirdDimension.Slave
Thug Life - Essence AGA	T/Thug Life - Essence AGA	A-Demos:T/ThugLifeAGA/ThugLifeAGA.Slave
Tint - The Black Lotus AGA	T/Tint - The Black Lotus AGA	A-Demos:T/TintAGA/TintAGA.Slave
Titan Trax 1 - Titanics	T/Titan Trax 1 - Titanics	A-Demos:T/TitanTrax/TitanTrax.Slave
Top Karaoke Vol.1 - Saturne	T/Top Karaoke Vol.1 - Saturn	A-Demos:T/TopKaraoke1/TopKaraoke1.Slave
Top Karaoke Vol.2 - Saturne AGA	T/Top Karaoke Vol.2 - Saturn	A-Demos:T/TopKaraoke2AGA/TopKaraoke2AGA.Slave
Top Karaoke Vol.3 - Capitaine Flam- - Saturne AGA	T/Top Karaoke Vol.3 - Capita	A-Demos:T/TopKaraoke3AGA/TopKaraoke3AGA.Slave
Total Kaos - LSD	T/Total Kaos - LSD	A-Demos:T/TotalKaos/TotalKaos.slave
Toxic Ziemniak - Alchemy	T/Toxic Ziemniak - Alchemy	A-Demos:T/ToxicZiemniak/ToxicZiemniak.Slave
Tragic magic - Rebels	T/Tragic magic - Rebels	A-Demos:T/TragicMagic/TragicMagic.Slave
Trash - Digital	T/Trash - Digital	A-Demos:T/Trash/Trash.Slave
Trashcan - Wizzcat	T/Trashcan - Wizzcat	A-Demos:T/Trashcan/Trashcan.Slave
Tropical sunset - The Silents	T/Tropical sunset - The Sile	A-Demos:T/TropicalSunset/TropicalSunset.Slave
Tune Disk 1 - Concept	T/Tune Disk 1 - Concept	A-Demos:T/TuneDisk1/TuneDisk1.Slave
Tuneshow II - Prophets AG,The Acoustic Revolution	T/Tuneshow II - Prophets AG.	A-Demos:T/TuneShow2/TuneShow2.slave
Tuneshow III - The Acoustic Revolution	T/Tuneshow III - The Acousti	A-Demos:T/TuneShow3/TuneShow3.Slave
Turmoil - Sanity	T/Turmoil - Sanity	A-Demos:T/Turmoil/Turmoil.slave
Turrican Musicdisk - Andromeda	T/Turrican Musicdisk - Andro	A-Demos:T/TurricanMusicDisk/TurricanMusicDisk.slave
Turrican Music-Show - Spreadpoint	T/Turrican Music-Show - Spre	A-Demos:T/TurricanMusicShow/TurricanMusicShow.Slave
Twisted - Polka brothers AGA	T/Twisted - Polka brothers A	A-Demos:T/TwistedAGA/TwistedAGA.Slave
Tympanic Membrane - Panacea	T/Tympanic Membrane - Panace	A-Demos:T/TympanicMembrane/TympanicMembrane.Slave
Ufonix - Enigma (UK)	U/Ufonix - Enigma UK	A-Demos:U/Ufonix/Ufonix.Slave
The Ultimate Gameboy Simulator - Tetris - Symbiosis	T/The Ultimate Gameboy Simul	A-Demos:U/UltimateGameBoySimulator/UltimateGameBoySimulator.Slave
Universal Intensity - Complex	U/Universal Intensity - Comp	A-Demos:U/UniversalIntensity/UniversalIntensity.Slave
Unleashed - Insane	U/Unleashed - Insane	A-Demos:U/Unleashed/Unleashed.Slave
Vaginal Massacre - U.d.o.	V/Vaginal Massacre - U.d.o.	A-Demos:V/VaginalMassacre/VaginalMassacre.slave
Vector balls - Hypnosis	V/Vector balls - Hypnosis	A-Demos:V/VectorBalls/VectorBalls.slave
Vector-Balls Demo - TomSoft Demo	V/Vector-Balls Demo - TomSof	A-Demos:V/VectorBallsDemo/VectorBallsDemo.Slave
Vector - Dual Crew Demo	V/Vector - Dual Crew Demo	A-Demos:V/VectorBobDemo/VectorBobDemo.slave
Vectordance - Cult	V/Vectordance - Cult	A-Demos:V/Vectordance/Vectordance.Slave
Vectordance 2 - Cult	V/Vectordance 2 - Cult	A-Demos:V/Vectordance2/Vectordance2.Slave
3d vector demo - Prophets AG,unicorn	0-9/3d vector demo - Prophets	A-Demos:V/VectorDemoProphetsAG/VectorDemoProphetsAG.Slave
Vector All Times - Tristan Lorach	V/Vector All Times - Tristan	A-Demos:V/VectorDemoTristanLorach/VectorDemoTristanLorach.Slave
Vector Exterminator - Shining	V/Vector Exterminator - Shin	A-Demos:V/VectorExterminator/VectorExterminator.Slave
Viktoria - TRSI	V/Viktoria - TRSI	A-Demos:V/Viktoria/Viktoria.Slave
Virtual Harmony - Impact DK	V/Virtual Harmony - Impact D	A-Demos:V/VirtualHarmony/VirtualHarmony.slave
Virtual World - TomSoft	V/Virtual World - TomSoft	A-Demos:V/VirtualWorld/VirtualWorld.Slave
Voyage - Fantasy Force	V/Voyage - Fantasy Force	A-Demos:V/VoyageFantasyForce/VoyageFantasyForce.slave
Voyage - Razor 1911	V/Voyage - Razor 1911	A-Demos:V/VoyageRazor1911/VoyageRazor1911.Slave
Walkman Music - IT	W/Walkman Music - IT	A-Demos:W/WalkmanMusic/WalkmanMusic.Slave
The Wall - Kefrens	T/The Wall - Kefrens	A-Demos:W/WallKefrens/WallKefrens.Slave
The Wall (Pink Floyd) - Split	T/The Wall Pink Floyd - Spli	A-Demos:W/WallSplit/WallSplit.slave
Water proof - Rebels	W/Water proof - Rebels	A-Demos:W/Waterproof/Waterproof.slave
Water proof - Rebels Fixed	W/Water proof - Rebels Fixed	A-Demos:W/WaterproofFixed/WaterproofFixed.slave
Wave Sound - Appendix	W/Wave Sound - Appendix	A-Demos:W/WaveSound/WaveSound.Slave
Wayfarer - Spaceballs	W/Wayfarer - Spaceballs	A-Demos:W/Wayfarer/Wayfarer.slave
We Will Smash You - TRSI	W/We Will Smash You - TRSI	A-Demos:W/WeWillSmashYou/WeWillSmashYou.Slave
When we ride on our enemies - Skarla AGA	W/When we ride on our enemie	A-Demos:W/WhenWeRideAGA/WhenWeRideAGA.slave
The White Room - Genesis (AFL)	T/The White Room - Genesis A	A-Demos:W/WhiteRoom/WhiteRoom.Slave
Wibbly Wobbly - Magnetic Fields	W/Wibbly Wobbly - Magnetic F	A-Demos:W/WibblyWobbly/WibblyWobbly.Slave
Wicked Sensation - Tristar & Red Sector Inc.	W/Wicked Sensation - Tristar	A-Demos:W/WickedSensation/WickedSensation.Slave
Wild - Anadune,Nah-Kolor AGA	W/Wild - Anadune.Nah-Kolor A	A-Demos:W/WildAGA/WildAGA.Slave
Wind It Up MegaMix 93 - Xymox Project	W/Wind It Up MegaMix 93 - Xy	A-Demos:W/WindItUp/WindItUp.Slave
With Vectors To Heaven - World Federation of Mad Hackers	W/With Vectors To Heaven - W	A-Demos:W/WithVectorsToHeaven/WithVectorsToHeaven.Slave
Wit Premium - Freezers AGA	W/Wit Premium - Freezers AGA	A-Demos:W/WitPremiumAGA/WitPremiumAGA.Slave
World of Commodore - Sanity	W/World of Commodore - Sanit	A-Demos:W/WorldOfCommodore/WorldOfCommodore.slave
World of Commodore - Sanity	W/World of Commodore - Sa V2	A-Demos:W/WorldOfCommodoreAltVer/WorldOfCommodoreAltVer.Slave
World Of Manga - Comax AGA	W/World Of Manga - Comax AGA	A-Demos:W/WorldOfMangaAGA/WorldOfMangaAGA.Slave
World Of Noise #1 - Digitech,Italian bad boys,knight hawks	W/World Of Noise 1 - Digitec	A-Demos:W/WorldOfNoise1/WorldOfNoise1.Slave
World's Wave - Subway	W/Worlds Wave - Subway	A-Demos:W/WorldsWave/WorldsWave.Slave
World's wave II - Subway,Dream Team	W/Worlds wave II - Subway.Dr	A-Demos:W/WorldsWave2/WorldsWave2.Slave
World's wave III - Subway,Dream Team	W/Worlds wave III - Subway.D	A-Demos:W/WorldsWave3/WorldsWave3.Slave
World's wave IV - Subway	W/Worlds wave IV - Subway	A-Demos:W/WorldsWave4/WorldsWave4.Slave
Xenon 2 Music Rip - Red Sector Inc.	X/Xenon 2 Music Rip - Red Se	A-Demos:X/Xenon2MusicRip/Xenon2MusicRip.Slave
Xpose - The Silents	X/Xpose - The Silents	A-Demos:X/XPose/XPose.slave
Zillion Dreams - Reflex	Z/Zillion Dreams - Reflex	A-Demos:Z/ZillionDreams/ZillionDreams.Slave