Hinch Demo - Decay Demo	H/Hinch Demo - Decay Demo	A-Demos:D/DerrynHinchDemo/DerrynHinchDemo.Slave
Hail the Engineer - Jetset	H/Hail the Engineer - Jetset	A-Demos:H/HailTheEngineer/HailTheEngineer.Slave
Hallucinations and dreams - preview - Katharsis	H/Hallucinations and dreams	A-Demos:H/Hallu&DreamsPrvKatharsis/Hallu&DreamsPrvKatharsis.Slave
Hallucinations and Dreams - Union	H/Hallucinations and Dreams 	A-Demos:H/Hallucinations&Dreams/Hallucinations&Dreams.slave
Hammer - Amaze	H/Hammer - Amaze	A-Demos:H/Hammer/Hammer.Slave
Hardcore - Anarchy	H/Hardcore - Anarchy	A-Demos:H/Hardcore/Hardcore.slave
Hardwired - Crionics,The Silents	H/Hardwired - Crionics.The S	A-Demos:H/Hardwired/Hardwired.Slave
Harmagedon - Infect AGA	H/Harmagedon - Infect AGA	A-Demos:H/HarmagedonAGA/HarmagedonAGA.Slave
Heliopolis - EMT Design	H/Heliopolis - EMT Design	A-Demos:H/Heliopolis/Heliopolis.Slave
Here we are - Awake	H/Here we are - Awake	A-Demos:H/HereWeAre/HereWeAre.Slave
Hexadecimal perfection - Action Direct	H/Hexadecimal perfection - A	A-Demos:H/HexadecimalPerfection/HexadecimalPerfection.slave
Highway 1930 - Fraxion	H/Highway 1930 - Fraxion	A-Demos:H/Highway1930/Highway1930.Slave
His Master's Noise - Mahoney & Kaktus	H/His Masters Noise - Mahone	A-Demos:H/HisMastersNoise/HisMastersNoise.slave
Hit Collection 1 - Commando	H/Hit Collection 1 - Command	A-Demos:H/HitCollection1/HitCollection1.Slave
Hit Fido - Kgb	H/Hit Fido - Kgb	A-Demos:H/HitFido/HitFido.Slave
Hit the Road - Flash Production	H/Hit the Road - Flash Produ	A-Demos:H/HitTheRoad/HitTheRoad.Slave
Hollywood Poker Slide - The Light Circle	H/Hollywood Poker Slide - Th	A-Demos:H/HollywoodPokerSlide/HollywoodPokerSlide.Slave
Hologon - The Electronic Knights	H/Hologon - The Electronic K	A-Demos:H/Hologon/Hologon.slave
Hologon - The Electronic Knights 512K	H/Hologon - The Electroni V2	A-Demos:H/Hologon512k/Hologon512k.slave
Honeycomb - Tristar & Red Sector Inc.	H/Honeycomb - Tristar Red Se	A-Demos:H/HoneyComb/HoneyComb.Slave
Hot Music 1 - Ram Jam	H/Hot Music 1 - Ram Jam	A-Demos:H/HotMusic1/HotMusic1.Slave
Hot Music 3 - Ram Jam	H/Hot Music 3 - Ram Jam	A-Demos:H/HotMusic3/HotMusic3.Slave
Hot Music 4 - Ram Jam	H/Hot Music 4 - Ram Jam	A-Demos:H/HotMusic4/HotMusic4.Slave
House Music - Vision	H/House Music - Vision	A-Demos:H/HouseMusic/HouseMusic.Slave
How To Skin A Cat - Melon Dezign	H/How To Skin A Cat - Melon	A-Demos:H/How2SkinACat/How2SkinACat.slave
Human Target - Melon Dezign	H/Human Target - Melon Dezig	A-Demos:H/HumanTarget/HumanTarget.Slave
Hymn 633 - Damage	H/Hymn 633 - Damage	A-Demos:H/Hymn633/Hymn633.slave
Hymns From The Bible 3 - Arcane	H/Hymns From The Bible 3 - A	A-Demos:H/HymnsFromTheBible3/HymnsFromTheBible3.Slave
Hoi Saga Demo I - Planet Groove - Team hoi AGA	H/Hoi Saga Demo I - Planet G	A-Demos:P/PlanetGrooveAGA/PlanetGrooveAGA.slave