Rainheart Project - BAD COMPANY	R/Rainheart Project - BAD CO	A-Demos:R/RainheartProject/RainheartProject.slave
Rampage - The Electronic Knights	R/Rampage - The Electronic K	A-Demos:R/Rampage/Rampage.Slave
Rap is Crap - Taipan	R/Rap is Crap - Taipan	A-Demos:R/RapIsCrap/RapIsCrap.Slave
Raverance - Cyclone	R/Raverance - Cyclone	A-Demos:R/Raverance/Raverance.slave
Ray of Hope - Majic 12	R/Ray of Hope - Majic 12	A-Demos:R/RayOfHope/RayOfHope.Slave
Ray of hope 2 - Majic 12	R/Ray of hope 2 - Majic 12	A-Demos:R/RayOfHope2/RayOfHope2.slave
Raytraced Dreams - Old Bulls	R/Raytraced Dreams - Old Bul	A-Demos:R/RaytracedDreams/RaytracedDreams.Slave
Real - Complex AGA	R/Real - Complex AGA	A-Demos:R/RealAGA/RealAGA.Slave
Real Empathy - Virtual	R/Real Empathy - Virtual	A-Demos:R/RealEmpathy/RealEmpathy.Slave
Reflex - Liquid	R/Reflex - Liquid	A-Demos:R/Reflex/Reflex.slave
Revenge - Fraxion	R/Revenge - Fraxion	A-Demos:R/Revenge/Revenge.Slave
Revolutions - Amaze	R/Revolutions - Amaze	A-Demos:R/Revolutions/Revolutions.Slave
Rhythm Device - Energy	R/Rhythm Device - Energy	A-Demos:R/RhythmDevice/RhythmDevice.Slave
Rhythm Nation - The Lost Boys	R/Rhythm Nation - The Lost B	A-Demos:R/RhythmNation/RhythmNation.Slave
Rink A Dink - Lemon.	R/Rink A Dink - Lemon.	A-Demos:R/RinkADink/RinkADink.Slave
Rink a Dink: REDUX - Lemon.	R/Rink a Dink REDUX - Lemon.	A-Demos:R/RinkADinkRedux/RinkADinkRedux.Slave
Rock Box 1 - Avoid	R/Rock Box 1 - Avoid	A-Demos:R/RockBox1/RockBox1.Slave
RockBox2 - Avoid	R/RockBox2 - Avoid	A-Demos:R/RockBox2/RockBox2.Slave
Rolling - Omega Machine Designers,Ringard	R/Rolling - Omega Machine De	A-Demos:R/Rolling/Rolling.Slave
Roots v2.0 - Sanity	R/Roots v2.0 - Sanity	A-Demos:R/Roots2/Roots2.Slave
Roots v2.0 - Sanity AGA	R/Roots v2.0 - Sanity AGA	A-Demos:R/Roots2AGA/Roots2AGA.Slave
Roots - Sanity AGA	R/Roots - Sanity AGA	A-Demos:R/RootsAGA/RootsAGA.slave
Roswell - NFA AGA	R/Roswell - NFA AGA	A-Demos:R/Roswell/Roswell.Slave
Route 66 - D-Mob	R/Route 66 - D-Mob	A-Demos:R/Route66/Route66.Slave
Royal Music - The Magic Guild	R/Royal Music - The Magic Gu	A-Demos:R/RoyalMusic/RoyalMusic.Slave
Royal Music 2 - The Magic Guild	R/Royal Music 2 - The Magic	A-Demos:R/RoyalMusic2/RoyalMusic2.Slave
Rubbish - Amega Industries	R/Rubbish - Amega Industries	A-Demos:R/Rubbish/Rubbish.Slave