Back 2 Base - Crusaders
Bacteria - The Crusaders
Bandit's Radio - Mad elks
Banging Raves - Intuition
Banging Raves 2 - Intuition
Bard in a box - Academy
Basso Continuo - Fury
Bass-o-matic - Crusaders
Batman Vuelve - Batman Group
Baygon - Melon Dezign AGA
BBS Intro - Taurus Intro
Beach Volley - Paradox Demo
Beast sonix - Scoopex
Beat Box - Warfalcons
Beatvise - Ivory
Bernard Sumner Music Disk 1 - Relay BernhardSumnerMD1
Best of RAF - Katharsis
Beyond Justice - Dexion
Beyond the future - Union AGA
Big business - Defjam
Big time sensuality - Axis AGA
Black Energy - Hardline
Black'n White Slide - Drifters,Pentagon (Amiga)
Blasting - Gate
Blue house 2 - Rebels
Blues House - The Silents
Bomb The Bass - Tuneshow 2 - The Top Boys
Book Of Songs - Complex
Boris Vallejo - Apocalypse Bay
Boulder Demo - Tristar Demo
Boundless Void - Nemol
Breathtaker - Virtual Dreams,Fairlight AGA
Breed CD1 - Nightbreed
Bruno's Musicbox II - Gate
Brunos box 3 - Anarchy
Bubonic Plague - Bloodsuckers
Burning Spear - The Dark Demon